أبو الفرج عبد الرحمن ابن الجوزي	أبو الفرج عبد الرحمن بن علي الجوزي	y
أبو الحسن عبد الرحمن بن ياسر الجوبري (المتوفى: 425هـ)	ياسر عبد الرحمن	n
أبو عبد الله محمد بن فتوح بن عبد الله الحميدي (المتوفى : 488هـ)	عبد الله بن يوسف بن محمد بن حيويه الجويني، أبو محمد (المتوفى: 438هـ)	n
أحمد بن علي بن حجر أبو الفضل العسقلاني	أحمد بن علي بن محمد بن علي بن حجر العسقلاني	y
أبو الفرج المعافى بن زكريا النهرواني (المتوفى : 390هـ)	أبو الفرج المعافى بن زكريا بن يحيى الجريرى النهرواني (المتوفى: 390هـ)	y
أبو القاسم خلف بن عبد الملك بن بشكوال (المتوفى: 578 هـ)	أبو القاسم خلف بن عبد الملك بن مسعود بن بشكوال الخزرجي الأنصاري الأندلسي (المتوفى: 578هـ)	y
ابن الجوزي	جمال الدين أبي الفرج عبد الرحمن بن الجوزي	y
أبو العباس أحمد بن خالد بن محمد الناصري	خالد محمد خالد	n
أبو الفرج عبد الرحمن بن الجوزي	عبد الرحمن بن علي بن محمد بن الجوزي أبو الفرج	y
أبو الفرج عبد الرحمن بن أبي الحسن الجوزي	أبو الفرج عبد الرحمن بن الجوزي الحنبلي	y
أبو الوليد سليمان بن خلف بن سعد بن أيوب بن وارث التجيبي القرطبي الباجي الأندلسي (المتوفى: 474هـ)	سليمان بن خلف بن سعد أبو الوليد الباجي	y
آخوند ملا أبو طالب الأراكي	أبو طالب	n
أبو الحسين محمد بن المظفر بن موسى بن عيسى بن محمد البغدادي	محمد بن المظفر بن موسى بن عيسى، أبو الحسين البزاز البغدادي (المتوفى : 379هـ)	y
عبد الملك بن عبد الله بن يوسف الجويني	عبد الملك بن عبد الله بن يوسف الجويني أبو المعالي	y
أبو العباس، أحمد بن عبد الله بن محمد، محب الدين الطبري (المتوفى: 694هـ)	أحمد محمد عبد الله	n
أبو بكر أحمد بن علي بن ثابت الخطيب	أحمد بن علي بن ثابت أبو بكر الخطيب البغدادي	y
أبو بكر بن أبي عاصم وهو أحمد بن عمرو بن الضحاك بن مخلد الشيباني (المتوفى: 287هـ)	عمرو بن أبي عاصم الضحاك الشيباني	y
أبو الحسنات محمد عبد الحي اللكنوي الهندي	أبو عبد الله محمد بن الحسن الشيباني (المتوفى: 189هـ) :: محمد عبد الحي بن محمد عبد الحليم الأنصاري اللكنوي الهندي، أبو الحسنات (المتوفى: 1304هـ)	m
أبو الفضل عبيد الله بن عبد الرحمن بن محمد بن عبيد الله بن سعد بن إبراهيم (المتوفى : 381هـ)	عبيد الله بن عبد الرحمن بن محمد بن عبيد الله بن سعد بن إبراهيم بن عبد الرحمن بن عوف العوفي، الزهري، القرشي، أبو الفضل البغدادي (المتوفى: 381هـ)	y
أبو الفرج عبد الرحمن بن الجوزي الحنبلي	محمد بن أبي الفتح البعلي الحنبلي أبو عبد الله	n
أبو الفضل العراقي	أبو الفضل عبد الرحيم بن الحسين العراقي	y
أبو إسماعيل عبد الله بن محمد الأنصاري الهروي (المتوفى: 481هـ)	عبد الله الأنصاري الهروي	y
أبو بكر جعفر بن محمد بن الحسن بن المستفاض الفريابي (المتوفى : 301هـ)	أبو بكر جعفر بن محمد بن الحسن بن المستفاض الفريابي (المتوفى: 301هـ)	y
أبو القاسم محمود بن عمر بن محمد بن عمر الخوارزمي الزمخشري	أبو القاسم محمود بن عمرو بن أحمد، الزمخشري جار الله (المتوفى: 538 هـ)	y
أبو الفرج محمد بن إسحاق بن محمد الوراق البغدادي المعتزلي الشيعي المعروف بابن النديم (المتوفى: 438هـ)	البغدادي	n
أحمد بن محمد بن علي بن حجر الهيتمي	ابن حجر الهيتمي	y
أبي الفضل جلال الدين عبد الرحمن السيوطي	السيوطي	y
أبو الفضل محمد بن طاهر بن علي بن أحمد المقدسي الشيباني، المعروف بابن القيسراني (المتوفى: 507هـ)	محمد بن طاهر المقدسي	y
أبو بكر عبد الرزاق بن همام الصنعاني	عبد الرزاق بن همام الصنعاني	y
أبو الفتح محمد بن عبد الكريم الشهرستاني	الشهرستاني	y
[ينسب لـ] عبد الملك بن محمد بن إسماعيل أبو منصور الثعالبي (المتوفى: 429هـ)	الثعالبي	y
أبو العباس أحمد بن يوسف التيفاشي (المتوفى : 651هـ)	أبو العباس أحمد بن يوسف التيفاشي (المتوفى: 651هـ)	y
أبو الندى معد بن نصر الله ، المعروف بابن الصيقل الجزري (المتوفى : 701هـ)	معد بن نصر الله بن رجب، أبو الندى شمس الدين ابن أبى الفتح، المعروف بابن الصيقل الجزري (المتوفى: 701هـ)	y
أبو الحسن علي بن خلف بن عبد الملك بن بطال البكري القرطبي	البكري	n
تقي الدين السبكي	تقي الدين علي بن عبد الكافي السبكي (المتوفى : 756هـ)	y
جمال الدين أبي الفرج عبد الرحمن ابن الجوزي	عبد الرحمن بن الجوزي أبو الفرج	y
أبي الفرج عبد الرحمن بن الجوزي	ابو الفرج عبد الرحمن بن علي بن الجوزي	y
علي بن أبي بكر الهيثمي أبو الحسن	نور الدين علي بن أبي بكر بن سليمان الهيثمي (المتوفى: 807هـ)	y
أبو الليث السمرقندي	أبو الليث نصر بن محمد بن أحمد بن إبراهيم السمرقندي (المتوفى: 373هـ)	y
أبو بكر جعفر بن محمد بن الحسن بن المستفاض الفريابي (المتوفى: 301هـ)	جعفر بن محمد بن الحسن الفريابي أبو بكر	y
أبو عبد الله محمد بن فتوح بن عبد الله الحميدي (المتوفى : 488هـ)	أحمد محمد عبد الله	n
أبو بكر أحمد بن علي بن ثابت بن أحمد بن مهدي الخطيب البغدادي (المتوفى: 463هـ)	أحمد بن علي أبو بكر الخطيب البغدادي	y
أبي الفرج عبد الرحمن بن الجوزي	ابن الجوزي	y
أبو بكر أحمد بن سلمان بن الحسن بن إسرائيل بن يونس النجاد (المتوفى: 348هـ)	أحمد بن سلمان النجاد أبو بكر	y
أبو الخير محمد بن أحمد بن محمد بن عمر بن القاسم بن عبد الله بن علي بن إسحاق بن سندار الأصبهاني، المقدر، المهندس، المؤذن، الصوفي، شهر بالباغبان. (المتوفى: 559هـ)	أحمد محمد عبد الله	n
أبو البركات	أبو البركات محمد بن محمد بن محمد الغزي (المتوفى : 984هـ)	n
علي بن إسماعيل الأشعري أبو الحسن	علي بن إسماعيل بن أبي بشر الأشعري أبو الحسن	y
أبو بكر عبد الرزاق بن همام بن نافع الحميري اليماني الصنعاني (المتوفى: 211هـ)	الحميري	n
أبو الحسن علي بن عمر بن أحمد بن مهدي بن مسعود بن النعمان بن دينار البغدادي الدارقطني (المتوفى : 385هـ)	علي بن عمر أبو الحسن الدارقطني البغدادي	y
أبو الحسن علي بن محمد الماوردي	أبو الحسن علي بن محمد بن حبيب البصري البغدادي الماوردي	y
أبو القاسم، محمد بن أحمد بن محمد بن عبد الله، ابن جزي الكلبي الغرناطي (المتوفى: 741هـ)	الغرناطي الكلبي	y
أبو بكر جعفر بن محمد بن الحسن بن المستفاض الفريابي	أبو بكر جعفر بن محمد بن الحسن بن المستفاض الفريابي (المتوفى : 301هـ)	y
إسماعيل بن عمر بن كثير الدمشقي أبو الفداء	إسماعيل بن عمر بن كثير القرشي أبو الفداء	y
أبو إسحاق إبراهيم بن إسحاق بن إبراهيم بن بشير بن عبد الله البغدادي الحربي (المتوفى: 285هـ)	إبراهيم بن إسحاق الحربي أبو إسحاق	y
أبو اسحاق إبراهيم بن علي الشيرازي (المتوفى: 476هـ)	أبو اسحاق إبراهيم بن علي بن يوسف الشيرازي (المتوفى: 476هـ)	y
أبو العباس أحمد بن عبد الواحد بن أحمد المقدسي، الحنبلي، الملقب بالبخاري (المتوفى: 623هـ)	الشمس، أبو العباس أحمد بن عبد الواحد بن أحمد المقدسي، الحنبلي، الملقب بالبخاري (المتوفى: 623هـ)	y
أبو الحسن علي بن عمر بن أحمد بن مهدي بن مسعود بن النعمان بن دينار البغدادي الدارقطني (المتوفى : 385هـ)	البغدادي	n
أبو الفضل محمد بن طاهر المقدسي المعروف بابن القيسراني	محمد بن طاهر المقدسي أبو الفضل	y
أبو الفضل عبد الرحيم بن الحسين العراقي	أبي الفضل زين الدين عبد الرحيم بن الحسين العراقي	y
أبو عبد الله محمد بن فتوح بن عبد الله الحميدي (المتوفى : 488هـ)	أبو محمد عبد الله بن يوسف الجرجاني (المتوفى: 489هـ)	n
أبو الفضل زين الدين عبد الرحيم بن الحسين بن عبد الرحمن بن أبي بكر بن إبراهيم العراقي (المتوفى: 806هـ)	أبو الفضل عبد الرحيم بن الحسين العراقي	y
أبو الحسين أحمد بن فارس زكريا	أحمد بن فارس بن زكريا بن محمد بن حبيب أبو الحسين الرازي	y
أبو بكر أحمد بن علي بن ثابت البغدادي الخطيب	أحمد بن علي بن ثابت البغدادي أبو بكر	y
أبو إسحاق إبراهيم بن إسحاق بن إبراهيم بن بشير بن عبد الله البغدادي الحربي (المتوفى: 285هـ)	الحربي	y
أبو النجا موسى بن أحمد، شرف الدين الحجاوي (المتوفى: 968هـ)	موسى بن أحمد بن موسى بن سالم بن عيسى بن سالم الحجاوي المقدسي، ثم الصالحي، شرف الدين، أبو النجا (المتوفى: 968هـ)	y
أبو الفرج عبد الرحمن بن الجوزي الحنبلي	أبو الفرج عبد الرحمن بن علي الجوزي	y
أبو الفضل محمد بن عبد الوهاب بن عبد اللطيف الأعرج (المتوفى: 925هـ)	عبد الوهاب	n
أبو القاسم عبد الرحمن بن عمر بن نصر بن محمد الشيباني، السامري، ثم الدمشقي، البزاز (المتوفى: 410هـ)	الشيباني	n
أبو الحسن محمد بن عبد الله بن زكريا بن حيويه النيسابوري المصري (المتوفى : 366هـ)	أبو الحسن محمد بن عبد الله بن زكريا بن حيويه النيسابوري ثم المصري الشافعي (المتوفى: 366هـ)	y
أبو الفرج عبد الرحمن ابن الجوزي	عبد الرحمن بن علي بن الجوزي	y
أبو بكر بن محمد بن عمر الملا الحنفي الإحسائي (المتوفى: 1270هـ)	أبو بكر محمد بن عمر الإحسائي	m
أبو الحسن علي بن حبيب الماوردي	أبو الحسن علي بن محمد بن حبيب البصري البغدادي الماوردي	y
أبو الفرج عبد الرحمن بن علي بن الجوزي	عبد الرحمن بن الجوزي أبو الفرج	y
أبو الطيب محمد صديق خان بن حسن بن علي ابن لطف الله الحسيني البخاري القنوجي (المتوفى: 1307هـ)	صديق بن حسن بن علي القنوجي	y
جمال الدين أبو الفرج عبد الرحمن بن علي بن محمد الجوزي (المتوفى: 597هـ)	جمال الدين أبي الفرج عبد الرحمن بن الجوزي	y
أبو الفرج عبد الرحمن بن علي بن الجوزي	عبد الرحمن بن علي بن محمد الجوزي	y
أبو نصر إسماعيل بن حماد الجوهري الفارابي (المتوفى: 393هـ)	الجوهري	y
أبو الحسين محمد بن المظفر (المتوفى: 379هـ)	أبو الحسين محمد بن المظفر بن موسى بن عيسى بن محمد البغدادي	y
أبو المنذر سلمة بن مسلم بن إبراهيم الصحاري العوتبي (العماني الإباضي) نسبة الى عوتب وهي منطقة في صحار كانت تسمى في القديم :عوتب الخيام (المتوفى : 511هـ)	أبو المنذر سلمة بن مسلم بن إبراهيم الصحاري العوتبي (العماني الإباضي) نسبة الى عوتب وهي منطقة في صحار كانت تسمى في القديم: عوتب الخيام (المتوفى: 511هـ)	y
أبو المنذر هشام بن محمد بن السائب الكلبي (المتوفى : 204هـ)	أبو المنذر هشام بن محمد بن السائب الكلبي (المتوفى: 204هـ)	y
أبي الفضل زين الدين عبد الرحيم بن الحسين العراقي	زين الدين أبو الفضل عبد الرحيم بن الحسين العراقي	y
تقي الدين أبي العباس أحمد بن علي بن عبد القادر العبيدي المقريزي	تقي الدين أحمد بن علي المقريزي	y
محمد بن طاهر بن علي المقدسي أبو الفضل	محمد بن طاهر بن علي بن القيسراني	y
أبو منصور الثعالبي	أبو منصور عبد الملك بن محمد بن إسماعيل الثعالبي	y
أبو الفرج عبد الرحمن بن أبي الحسن الجوزي	عبد الرحمن بن علي بن الجوزي	y
أبو القاسم علي بن الحسن بن هبة الله المعروف بابن عساكر (المتوفى : 571هـ)	أبو القاسم علي بن الحسن بن هبة الله المعروف بابن عساكر (المتوفى: 571هـ)	y
أبو إسحاق أحمد بن محمد بن إبراهيم الثعلبي النيسابوري	محمد بن أحمد بن إسحاق	n
أبو العلاء أحمد بن عبد الله بن سليمان بن محمد بن السليمان المعري	أبو العلاء المعري	m
أبو العباس أحمد بن محمد بن علي ابن حجر الهيثمي	الهيثمي	m
أبو الحسين محمد بن المظفر (المتوفى: 379هـ)	محمد بن المظفر بن موسى بن عيسى، أبو الحسين البزاز البغدادي (المتوفى : 379هـ)	y
خيثمة الأطرابلسي	خيثمة بن سليمان الأطرابلسي	y
أبو الفرج مسعود بن الحسن الثقفي الأصبهاني (المتوفى: 562هـ)	الأصبهاني	n
أبو بكر أحمد بن علي بن ثابت الخطيب البغدادي	أحمد بن علي بن ثابت البغدادي	y
أبو الفرج عبد الرحمن بن علي بن محمد بن علي بن عبيد الله بن عبد الله بن هادي بن أحمد بن محمد بن جعفر الجوزي	عبد الرحمن بن علي بن الجوزي	y
أبو منصور عبد الملك بن محمد بن إسماعيل الثعالبي	الثعالبي	y
أبو الفرج عبد الرحمن بن أبي الحسن الجوزي	أبو الفرج عبد الرحمن بن علي بن محمد بن علي بن الجوزي	y
أحمد بن الحسين بن علي بن موسى الخسروجردي الخراساني، أبو بكر البيهقي (المتوفى : 458هـ)	البيهقي	y
أبو الحسن علي بن أحمد بن محمد بن علي الواحدي، النيسابوري، الشافعي (المتوفى: 468هـ)	علي بن أحمد الواحدي أبو الحسن	y
أبو الفرج عبد الرحمن بن علي الجوزي	جمال الدين أبو الفرج عبد الرحمن بن علي بن محمد الجوزي (المتوفى: 597هـ) (منسوب خطأ في المطبوع لابن قيم الجوزية)	y
أبو بكر أحمد بن إبراهيم بن إسماعيل بن العباس بن مرداس الإسماعيلي الجرجاني (المتوفى: 371هـ)	أحمد بن إبراهيم بن إسماعيل الإسماعيلي أبو بكر	y
أبو الحسن خيثمة بن سليمان بن حيدرة بن سليمان القرشي الشامي الأطرابلسي (المتوفى: 343هـ)	خيثمة الأطرابلسي	y
أبو الفرج عبد الرحمن بن علي الجوزي	عبد الرحمن بن علي بن محمد أبو الفرج	y
أبو الحارث الليث بن سعد بن عبد الرحمن الفهمي المصري (المتوفى: 175هـ)	الليث بن سعد	y
أحمد بن علي بن حجر العسقلاني	أحمد بن علي بن محمد بن علي بن حجر العسقلاني	y
أبو بكر أحمد بن الحسين البيهقي	أحمد بن الحسين بن علي بن موسى الخسروجردي الخراساني، أبو بكر البيهقي (المتوفى: 458هـ)	y
أبو الحسن ظهير الدين علي بن زيد البيهقي، الشهير بابن فندمه (المتوفى: 565هـ)	أبو الحسن ظهير الدين علي بن زيد بن محمد بن الحسين البيهقي، الشهير بابن فندمه (المتوفى: 565هـ)	y
أبو الحسن على بن الحسين بن على المسعودي (المتوفى : 346هـ)	المسعودي	y
الحافظ أبو الفضل جلال الدين عبد الرحمن ابن أبي بكر السيوطي	السيوطي	y
أبو القاسم محمود بن عمرو بن أحمد، الزمخشري جار الله (المتوفى: 538هـ)	الزمخشري	y
أحمد بن علي أبو بكر الخطيب البغدادي	أحمد بن علي بن ثابت البغدادي	y
أبو بكر محمد بن جعفر بن محمد بن سهل بن شاكر الخرائطي (المتوفى : 327هـ)	أبو بكر محمد بن جعفر بن محمد بن سهل بن شاكر الخرائطي (المتوفى: 327هـ)	y
أحمد بن علي بن عبد القادر بن محمد المقريزي (المتوفى : 845هـ)	المقريزي	y
الهيثمي	علي بن أبي بكر الهيثمي	y
أبو المنذر هشام بن محمد أبي النضر ابن السائب ابن بشر الكلبي (المتوفى: 204هـ)	أبو المنذر هشام بن محمد بن السائب الكلبي (المتوفى: 204هـ)	y
عبد الله الأنصاري الهروي	عبد الله بن محمد بن علي بن محمد الهروي أبو إسماعيل	y
أبو العباس أحمد بن محمد بن علي ابن حجر الهيثمي	ابن حجر	n
أبو بكر بن أبي داود السجستاني عبد الله بن بن سليمان بن الأشعث	سليمان بن الأشعث السجستاني أبو داود	m
أبو إسحاق إبراهيم بن إسحاق بن إبراهيم بن بشير البغدادي الحربي (المتوفى: 285هـ)	البغدادي	n
الدارقطني	علي بن عمر بن أحمد الدارقطني	y
أبو الفضل محمد بن طاهر المقدسي المعروف بابن القيسراني	أبو الفضل محمد بن طاهر بن علي بن أحمد المقدسي الشيباني، المعروف بابن القيسراني (المتوفى: 507هـ)	y
عبد الرحمن بن إسحاق البغدادي النهاوندي الزجاجي، أبو القاسم (المتوفى : 337هـ)	عبد الرحمن بن إسحاق البغدادي النهاوندي الزجاجي، أبو القاسم (المتوفى: 337هـ)	y
أبو الفرج عبد الرحمن بن علي بن محمد بن علي بن عبيد الله بن عبد الله بن هادي بن أحمد بن محمد بن جعفر الجوزي	جمال الدين أبي الفرج عبد الرحمن ابن الجوزي	y
أبو البقاء العكبري	الشيخ الامام محب الدين أبي البقاء عبد الله بن الحسين العكبري الحنبلي	y
أبو العباس محمد بن إسحاق بن إبراهيم بن مهران الخراساني النيسابوري المعروف بالسراج (المتوفى : 313هـ)	أبو العباس محمد بن إسحاق بن إبراهيم بن مهران الخراساني النيسابوري المعروف بالسراج (المتوفى: 313هـ)	y
أبو الحسن علي بن عمر بن أحمد بن مهدي بن مسعود بن النعمان بن دينار البغدادي الدارقطني (المتوفى: 385هـ)	الدارقطني	y
أبو الفرج عبد الرحمن بن علي بن محمد القرشي	جمال الدين أبو الفرج عبد الرحمن بن علي بن محمد الجوزي (المتوفى: 597هـ)	y
أبو الحسن نور الدين علي بن أبي بكر بن سليمان الهيثمي (المتوفى: 807هـ)	الهيثمي	y
أحمد بن علي بن ثابت أبو بكر الخطيب البغدادي	أحمد بن علي بن ثابت البغدادي	y
أبو بكر بن أبي عاصم وهو أحمد بن عمرو بن الضحاك بن مخلد الشيباني (المتوفى: 287هـ)	أحمد بن عمرو بن أبي عاصم الضحاك أبو بكر	y
أبو بكر أحمد بن محمد ابن الحافظ الكبير أبي بكر أحمد بن موسى بن مردويه بن فورك بن موسى الأصبهاني (المتوفى: 498هـ)	ابن مردويه	y
أبو الفضل بن عمار الشهيد	أبو الفضل محمد بن أبي الحسين أحمد بن محمد بن عمار بن محمد بن حازم بن المعلى بن الجارود الجارودي، الهروي، الشهيد (المتوفى: 317هـ)	y
أبو القاسم محمود بن عمرو بن أحمد، الزمخشري جار الله (المتوفى: 538 هـ)	محمود بن عمر الزمخشري	y
أبو إسحاق إبراهيم بن محمد بن يحيى بن سختويه النيسابوري المزكي (المتوفى: 362هـ)	محمد بن إسحاق بن يحيى	n
أبو الفرج عبد الرحمن بن الجوزي	أبو الفرج عبد الرحمن بن علي الجوزي	y
أبو القاسم سليمان بن أحمد الطبراني	سليمان بن أحمد بن أيوب بن مطير اللخمي الشامي، أبو القاسم الطبراني (المتوفى : 360هـ)	y
أحمد بن عبد الله العمري	شهاب الدين أحمد بن يحيى بن فضل الله العمري (المتوفى : 749هـ)	m
أبو بكر بن أبي شيبة، عبد الله بن محمد بن إبراهيم بن عثمان بن خواستي العبسي (المتوفى: 235هـ)	أبو بكر عبد الله بن محمد بن أبي شيبة الكوفي	y
أبو إسماعيل عبد الله بن محمد بن علي الأنصاري الهروي (المتوفى: 481هـ)	الأنصاري الهروي	y
الدارقطني	علي بن عمر الدارقطني	y
أبو بكر أحمد بن علي بن ثابت البغدادي الخطيب	أحمد بن علي بن ثابت الخطيب البغدادي	y
عبد الملك الجويني	عبد الملك بن عبد الله بن يوسف بن محمد الجويني، أبو المعالي، ركن الدين، الملقب بإمام الحرمين (المتوفى: 478هـ)	y
أبو الحسن هلال بن المحسن بن إبراهيم الصابي	إبراهيم إبراهيم هلال	n
أبو الفرج عبد الرحمن ابن الجوزي	جمال الدين أبو الفرج عبد الرحمن بن علي بن محمد الجوزي (المتوفى: 597هـ)	y
أبو الفضل العراقي	عبد الرحيم العراقي	y
أبو القاسم محمود بن عمرو بن أحمد، الزمخشري جار الله (المتوفى: 538 هـ)	جار الله الزمخشري	y
أبو الحسن علي بن عمر بن أحمد بن مهدي بن مسعود بن النعمان بن دينار البغدادي الدارقطني (المتوفى : 385هـ)	علي بن عمر بن أحمد الدارقطني	y
أبو العباس جعفر بن محمد بن المعتز بن محمد بن المستغفر بن الفتح بن إدريس المستغفري، النسفي (المتوفى: 432هـ)	النسفي	n
أبو المظفر منصور بن محمد بن عبد الجبار السمعاني	منصور بن محمد السمعاني أبو المظفر	y
أبو الفرج عبد الرحمن بن علي بن محمد بن علي بن الجوزي	عبد الرحمن بن علي بن محمد بن الجوزي أبو الفرج	y
أبو بكر أحمد بن الحسين بن علي بن عبد الله البيهقي	أحمد بن الحسين بن علي البيهقي أبو بكر	y
أبو الحسن علي بن محمد ، المعروف بالشابشتي (المتوفى : 388هـ)	أبو الحسن علي بن محمد، المعروف بالشابشتي (المتوفى: 388هـ)	y
أبو بشر محمد بن أحمد بن حماد بن سعيد بن مسلم الأنصاري الدولابي الرازي (المتوفى: 310هـ)	الإمام الحافظ أبو بشر محمد بن أحمد بن حماد الدولابي	y
أبو الحسن القاضي أحمد بن سليمان بن أيوب بن داود بن عبد الله بن حذلم الأسدي الدمشقي الأوزاعي (المتوفى: 347هـ)	الحسن بن أحمد بن عبد الله أبو علي	n
أحمد بن علي العسقلاني أبو الفضل	أحمد بن علي بن حجر	y
أبو الفرج عبد الرحمن بن أحمد بن رجب الحنبلي	أبو الفرج عبد الرحمن بن أحمد بن رجب الحنبلي (المتوفى: 795هـ)	y
أبو إسماعيل عبد الله بن محمد بن علي الأنصاري الهروي (المتوفى: 481هـ)	عبد الله بن محمد الهروي	y
أبو الفرج عبد الرحمن ابن الجوزي	أبو الفرج عبد الرحمن بن علي بن محمد القرشي	y
أبو القاسم محمود بن عمرو بن أحمد، الزمخشري جار الله (المتوفى: 538هـ)	محمود بن عمر الزمخشري	y
أبو القاسم الحسين بن محمد	شمس الدين، أبو القاسم الحسين ابن أبي الغنائم هبة الله بن محفوظ بن الحسن بن محمد بن الحسن بن أحمد بن الحسين بن صصرى الربعي، التغلبي، الجزري، البلدي، الدمشقي (المتوفى: 626هـ)	n
أبو المظفر منصور بن محمد بن عبد الجبار السمعاني	السمعاني	y
أبو الحسن علي بن عبد العزير القاضي الجرجاني (المتوفى : 392هـ)	أبو الحسن علي بن عبد العزير القاضي الجرجاني (المتوفى: 392هـ)	y
أبو العباس أحمد بن أبي أحمد الطبري المعروف بـ ابن القاص (المتوفى: 335هـ)	الطبري	n
أبو القاسم إسماعيل بن أحمد بن عمر بن أبي الأشعث السمرقندي، الدمشقي المولد، البغدادي الوطن (المتوفى: 536هـ)	السمرقندي	m
أبو الفضل عبد الرحمن جلال الدين السيوطي	جلال الدين السيوطي	y
أبو عبد الله محمد بن فتوح بن عبد الله الحميدي (المتوفى : 488هـ)	محمد بن فتوح الحميدي	y
أبو عبد الله محمد بن فتوح بن عبد الله الحميدي (المتوفى : 488هـ)	عبد الله بن محمد البصيري	n
أبو الفرج عبد الرحمن بن علي بن محمد بن علي بن عبيد الله بن عبد الله بن هادي بن أحمد بن محمد بن جعفر الجوزي	ابن الجوزي	y
أبو القاسم عبد الله بن محمد بن عبد العزيز البغوي	عبد الله بن محمد البغوي	y
أبو بكر أحمد بن جعفر بن حمدان بن مالك بن شبيب البغدادي المعروف بالقطيعي (المتوفى: 368هـ)	البغدادي	n
أبو القاسم محمود بن عمر الزمخشري الخوارزمي	أبو القاسم محمود بن عمرو بن أحمد، الزمخشري جار الله (المتوفى : 538هـ)	y
أبو الحسن ظهير الدين علي بن زيد البيهقي ، الشهير بابن فندمه (المتوفى : 565هـ)	ظهير الدين علي بن زيد البيهقي (المتوفى : 565هـ)	y
الحافظ أبو الفضل جلال الدين عبد الرحمن ابن أبي بكر السيوطي	جلال الدين أبي الفضل عبد الرحمن السيوطي	y
أبو الحسن علي بن عمر بن أحمد بن مهدي بن مسعود بن النعمان بن دينار البغدادي الدارقطني (المتوفى: 385هـ)	البغدادي	n
أبو الحسن الدارقطني	علي بن عمر بن أحمد الدارقطني أبو الحسن	y
أبو القاسم عبد الله بن محمد بن عبد العزيز بن المرزبان بن سابور بن شاهنشاه البغوي (المتوفى: 317هـ)	عبد الله بن محمد بن عبد العزيز البغوي أبو القاسم	y
أبو القاسم محمود بن عمر بن محمد بن عمر الخوارزمي الزمخشري	الزمخشري	y
أبو السعادات المبارك بن محمد الجزري	مجد الدين أبو السعادات المبارك بن محمد بن محمد بن محمد ابن عبد الكريم الشيباني الجزري ابن الأثير (المتوفى: 606هـ)	y
أحمد بن علي بن ثابت البغدادي	أحمد بن علي بن ثابت البغدادي أبو بكر	y
أبو العباس شهاب الدين أحمد بن محمد مكي الحسيني الحموي الحنفي	الحموي	n
علي بن عمر أبو الحسن الدارقطني	علي بن عمر بن أحمد الدارقطني أبو الحسن	y
أبو الحسين عبد الوهاب بن الحسن بن الوليد بن موسى الكلابي الدمشقي (المتوفى: 396هـ)	عبد الوهاب	n
أبو بكر بن أبي شيبة	أبو بكر بن أبي شيبة، عبد الله بن محمد بن إبراهيم بن عثمان بن خواستي العبسي (المتوفى: 235هـ)	y
أبو بكر أحمد بن علي بن ثابت بن أحمد بن مهدي الخطيب البغدادي (المتوفى: 463هـ)	الخطيب البغدادي	y
أبو العباس، عبد الله بن محمد المعتز بالله ابن المتوكل ابن المعتصم ابن الرشيد العباسي (المتوفى: 296هـ)	عبد الله بن محمد ابن المعتز العباسي (المتوفى: 296هـ)	y
الباقلاني	محمد بن الطيب بن محمد بن جعفر بن القاسم، القاضي أبو بكر الباقلاني المالكي (المتوفى: 403هـ)	y
الزمخشري	محمود بن عمر الزمخشري	y
أبو بكر عبد الله بن محمد بن عبيد البغدادي (ابن أبي الدنيا)	أبو بكر عبد الله بن محمد بن عبيد بن أبي الدنيا (المتوفى : 281هـ)	y
أبو القاسم الحسن بن بشر الآمدي (المتوفى: 370هـ)	الآمدي	n
أبو الفضل جلال الدين عبد الرحمن أبي بكر السيوطي	جلال الدين أبي الفضل عبد الرحمن السيوطي	y
أبو الفضل أحمد بن علي بن محمد بن أحمد بن حجر العسقلاني (المتوفى: 852هـ)	أحمد بن علي بن حجر العسقلاني	y
أبو الفرج عبد الرحمن بن الجوزي	أبو الفرج عبد الرحمن بن علي بن محمد بن علي بن الجوزي	y
أبو الفرج عبد الرحمن بن أبي الحسن الجوزي	عبد الرحمن بن علي بن محمد أبو الفرج	y
أبو العباس أحمد بن محمد بدر الدين ابن محمد شمس الدين ابن علي نور الدين ابن حجر الهيتمي	أحمد بن محمد بن علي بن حجر الهيتمي	y
أحمد بن علي بن حجر العسقلاني أبو الفضل	أحمد بن علي بن محمد بن علي بن حجر العسقلاني	y
أبو الفضل أحمد بن أبي طاهر ابن طيفور (المتوفى : 280هـ)	ابن طيفور	m
عبد الله الأنصاري الهروي	عبد الله بن محمد الهروي	y
أحمد بن الحسين بن علي بن موسى أبو بكر البيهقي	الحافظ الامام أبو بكر أحمد بن الحسين بن علي بن موسى أبو أحمد. البيهقي. الخسروجردي	y
أبو البركات	أبو البركات بدر الدين محمد بن محمد الغزي	n
محمد بن المظفر بن موسى بن عيسى، أبو الحسين البزاز البغدادي (المتوفى : 379هـ)	محمد بن المظفر بن موسى بن عيسى، أبو الحسين البزاز البغدادي (المتوفى: 379هـ)	y
أبو القاسم محمود بن عمر الزمخشري	جار الله الزمخشري	y
أبو بكر بن أبي داود السجستاني عبد الله بن بن سليمان بن الأشعث	عبد الله بن سليمان السجستاني	y
صديق بن حسن بن علي القنوجي	محمد صديق حسن خان القنوجي	y
أبو منصور الثعالبي	أبو منصور عبد الملك عبد الملك بن محمد بن إسماعيل الثعالبي	y
أبو الفرج الأصبهاني	أبو الفرج مسعود بن الحسن الثقفي الأصبهاني (المتوفى: 562هـ)	m
أبو المنجى عبد الله بن عمر بن علي بن زيد، ابن اللتي البغدادي، الحريمي، الطاهري، القزاز (المتوفى: 635هـ)	البغدادي	n
أبو الحسن علي بن إسماعيل بن سيده المرسي (المتوفى: 458هـ)	علي بن إسماعيل بن سيده (المتوفى : 458هـ)	y
أحمد بن علي العسقلاني أبو الفضل	أحمد بن علي بن حجر العسقلاني	y
أبو العباس شهاب الدين أحمد بن أبي بكر بن إسماعيل بن سليم بن قايماز بن عثمان البوصيري الكناني الشافعي (المتوفى: 840هـ)	أحمد بن أبي بكر بن إسماعيل الكناني	y
أبو المجد اسعد بن إبراهيم الشيباني الإربلي المعروف بمجد الدين النشابي الكاتب (المتوفى : 657هـ)	أبو المجد اسعد بن إبراهيم الشيباني الإربلي المعروف بمجد الدين النشابي الكاتب (المتوفى: 657هـ)	y
أبو الفرج عبد الرحمن بن علي الجوزي	عبد الرحمن بن علي بن الجوزي	y
أبو الحسن علي بن أحمد بن محمد بن علي الواحدي، النيسابوري، الشافعي (المتوفى : 468هـ)	علي بن أحمد الواحدي أبو الحسن	y
أبو الفضل العراقي	زين الدين أبو الفضل عبد الرحيم بن الحسين العراقي	y
أبو بكر أحمد بن علي بن ثابت البغدادي الخطيب	الخطيب البغدادي	y
أبو الخطاب عمر بن حسن الأندلسي الشهير بابن دحية الكلبي (المتوفى : 633هـ)	أبو الخطاب عمر بن حسن الأندلسي الشهير بابن دحية الكلبي (المتوفى: 633هـ)	y
أبو الحسن علي بن عمر بن أحمد الدارقطني	الدارقطني	y
أحمد بن علي بن حجر أبو الفضل العسقلاني	أحمد بن علي بن حجر العسقلاني أبو الفضل	y
الأنصاري الهروي	عبد الله بن محمد الهروي	y
أبو القاسم محمود بن عمرو بن أحمد، الزمخشري جار الله (المتوفى : 538هـ)	جار الله الزمخشري	y
أبو الفرج عبد الرحمن بن علي بن محمد القرشي	أبو الفرج عبد الرحمن بن علي بن محمد بن علي بن الجوزي	y
الضحاك	عمرو بن أبي عاصم الضحاك الشيباني	y
أبو الحسن ظهير الدين علي بن زيد البيهقي ، الشهير بابن فندمه (المتوفى : 565هـ)	أبو الحسن ظهير الدين علي بن زيد بن محمد بن الحسين البيهقي، الشهير بابن فندمه (المتوفى: 565هـ)	y
[ينسب لـ] عبد الملك بن محمد بن إسماعيل أبو منصور الثعالبي (المتوفى: 429هـ)	أبو منصور عبد الملك بن محمد بن إسماعيل الثعالبي	y
أبو القاسم الحسين بن محمد	أبو القاسم الحسين بن محمد المعروف بالراغب الأصفهانى (المتوفى: 502هـ)	y
ابن الأثير	عز الدين بن الأثير أبي الحسن علي بن محمد الجزري	y
أبو الفرج عبد الرحمن بن الجوزي الحنبلي	عثمان بن عبد الرحمن	n
أحمد بن عمرو بن أبي عاصم الشيباني	أحمد بن عمرو بن أبي عاصم الضحاك أبو بكر	y
أبو بكر أحمد بن علي بن ثابت بن أحمد بن مهدي الخطيب البغدادي (المتوفى: 463هـ)	أحمد بن علي بن ثابت البغدادي أبو بكر	y
أبو أمية محمد بن إبراهيم بن مسلم الخزاعي البغدادي ثم الطرسوسي (المتوفى: 273هـ)	البغدادي	n
أبو بشر محمد بن أحمد بن حماد الدولابي	الإمام الحافظ أبو بشر محمد بن أحمد بن حماد الدولابي	y
أبو القاسم الحسن بن بشر الآمدي (المتوفى: 370 هـ)	أبو القاسم الحسن بن بشر الآمدي (المتوفى: 370هـ)	y
أبو الفرج عبد الرحمن بن علي بن الجوزي	جمال الدين أبو الفرج عبد الرحمن بن علي بن محمد الجوزي (المتوفى: 597هـ)	y
أبو القاسم عبد الله بن محمد بن عبد العزيز البغوي	عبد الله بن محمد بن عبد العزيز البغوي أبو القاسم	y
أبو المعالي الجويني الملقب بإمام الحرمين (المتوفى: 478هـ)	عبد الملك بن عبد الله بن يوسف الجويني أبو المعالي	y
أبو الوليد محمد بن أحمد بن محمد بن أحمد بن رشد القرطبي الشهير بابن رشد الحفيد (المتوفى : 595هـ)	محمد بن أحمد بن أحمد بن رشد القرطبي أبو الوليد	n
أبو الحسين هلال بن المحسن الصابئ	هلال بن المحسن بن إبراهيم بن هلال الصابئ الحراني، أبو الحسين، أو أبو الحسن (المتوفى: 448هـ)	y
ابن الجوزي	عبد الرحمن بن الجوزي أبو الفرج	y
أبو منصور عبد الملك بن محمد بن إسماعيل الثعالبي	أبي منصور عبد الملك بن محمد بن إسماعيل الثعالبي	y
أبو الفضل عبد الرحمن جلال الدين السيوطي	السيوطي	y
أبو الفرج عبد الرحمن ابن الجوزي	أبو الفرج عبد الرحمن بن الجوزي الحنبلي	y
أبو الحسن سيد الدين علي بن أبي علي بن محمد بن سالم الثعلبي الآمدي (المتوفى: 631هـ)	علي بن محمد الآمدي أبو الحسن	y
أبو الفضل عبد الرحمن بن أحمد بن الحسن بن بندار العجلي الرازي المقرئ	العجلي	n
أبو الحسن علي بن عبد العزير القاضي الجرجاني (المتوفى : 392هـ)	الجرجاني	n
ابو الفرج عبد الرحمن بن علي بن الجوزي	عبد الرحمن بن الجوزي أبو الفرج	y
أبو أحمد محمد بن أحمد بن حسين بن القاسم بن السري بن الغطريف بن الجهم العبدي الغطريفي الجرجاني (المتوفى: 377هـ)	محمد بن أحمد بن الغطريف الجرجاني	y
ثقة الدين، أبو القاسم علي بن الحسن بن هبة الله المعروف بابن عساكر (المتوفى: 571هـ) من تخريجه لشيخة الفراوي	علي بن الحسن بن هبة الله أبو القاسم	y
علي بن عمر أبو الحسن الدارقطني البغدادي	علي بن عمر بن أحمد بن مهدي أبو الحسن الدارقطني البغدادي	y
أبو بكر بن أبي عاصم وهو أحمد بن عمرو بن الضحاك بن مخلد الشيباني (المتوفى: 287هـ)	الضحاك	y
أبو القاسم محمود بن عمر الزمخشري	محمود بن عمر الزمخشري	y
أبو الفرج عبد الرحمن بن أحمد بن رجب الحنبلي	عبد الرحمن بن أحمد بن رجب الحنبلي (المتوفى : 795هـ)	y
أبو القاسم عبد الله بن محمد بن عبد العزيز بن المرزبان بن سابور بن شاهنشاه البغوي (المتوفى: 317هـ)	عبد الله بن محمد بن عبد العزيز بن المرزبان البغوي أبو القاسم	y
أحمد بن الحسين البيهقي أبو بكر	الحافظ الامام أبو بكر أحمد بن الحسين بن علي بن موسى أبو أحمد. البيهقي. الخسروجردي	y
عبد الرحمن بن أحمد بن رجب الحنبلي (المتوفى : 795هـ)	عبد الرحمن بن أحمد بن رجب الحنبلي (المتوفى: 795هـ)	y
جمال الدين أبو الفرج عبد الرحمن بن علي بن محمد الجوزي (المتوفى: 597هـ)	عبد الرحمن بن الجوزي أبو الفرج	y
أبو القاسم تمام بن محمد بن عبد الله بن جعفر بن عبد الله بن الجنيد البجلي الرازي ثم الدمشقي (المتوفى: 414هـ)	الرازي	n
أبو بكر عبد الله بن أبي الدنيا	أبو بكر عبد الله بن محمد بن أبي الدنيا	y
أحمد بن الحسين البيهقي أبو بكر	أحمد بن الحسين بن علي بن موسى الخسروجردي الخراساني، أبو بكر البيهقي (المتوفى : 458هـ)	y
أبو بكر جعفر بن محمد بن الحسن بن المستفاض الفريابي (المتوفى : 301هـ)	جعفر بن محمد بن الحسن الفريابي أبو بكر	y
أبو بكر عبد الله بن سليمان بن الأشعث السجستاني	عبد الله بن سليمان السجستاني	y
أبو العباس محمد بن يزيد المبرد	محمد بن يزيد المبرد، أبو العباس (المتوفى: 285هـ)	y
أبو بكر أحمد بن علي بن ثابت الخطيب البغدادي	أحمد بن علي أبو بكر الخطيب البغدادي	y
أحمد بن عمرو بن أبي عاصم الشيباني	عمرو بن أبي عاصم	y
الحسن بن عبد الله العسكري أبو أحمد	العسكري	y
جمال الدين أبي الفرج عبد الرحمن ابن الجوزي	عبد الرحمن بن علي بن محمد بن الجوزي أبو الفرج	y
أبو القاسم علي بن الحسن بن هبة الله المعروف بابن عساكر (المتوفى : 571هـ)	علي بن الحسن بن هبة الله أبو القاسم	y
أبو المظفر مؤيد الدولة مجد الدين أسامة بن مرشد بن علي بن مقلد بن نصر بن منقذ الكناني الكلبي الشيزري (المتوفى: 584هـ)	أبو المظفر مؤيد الدولة مجد الدين أسامة بن مرشد بن علي بن منقذ الكناني (المتوفى : 584هـ)	y
أبو الفرج عبد الرحمن ابن الجوزي	عبد الرحمن بن علي بن محمد الجوزي	y
أبو محمد الحسن بن عبد الرحمن بن خلاد الرامهرمزي الفارسي (المتوفى: 360هـ)	الرامهرمزي	y
أبو الحسن علي بن محمد الماوردي	أبو الحسن علي بن محمد الماوردي الشافعي	y
أبو البقاء عبد الله بن الحسين بن عبد الله العكبري	أبو البقاء عبد الله بن الحسين بن عبد الله العكبري البغدادي محب الدين (المتوفى: 616هـ)	y
أبو الفتح محمد بن الحسين بن أحمد بن عبد الله بن بريدة الموصلي الأزدي (المتوفى: 374هـ)	محمد بن الحسين أبو الفتح الأزدي الموصلي	y
أبو بكر عبد الله بن محمد بن أبي الدنيا	أبو بكر عبد الله بن محمد بن عبيد البغدادي (ابن أبي الدنيا)	y
أبو البقاء عبد الله بن الحسين العكبري	الشيخ الامام محب الدين أبي البقاء عبد الله بن الحسين العكبري الحنبلي	y
أحمد بن عمرو بن أبي عاصم الضحاك أبو بكر	الضحاك	y
أبو الفضل أحمد بن محمد الميداني النيسابوري	أبو الفضل أحمد بن محمد بن إبراهيم الميداني النيسابوري (المتوفى: 518هـ)	y
أبو الحسن علي بن إسماعيل بن سيده المرسي [ت: 458هـ]	علي بن إسماعيل بن سيده (المتوفى : 458هـ)	y
أحمد بن علي بن عبد القادر، أبو العباس الحسيني العبيدي، تقي الدين المقريزي (المتوفى: 845هـ)	تقي الدين أحمد بن علي المقريزي	y
أبو القاسم علي بن الحسن بن هبة الله المعروف بابن عساكر (المتوفى: 571هـ)	علي بن الحسن بن هبة الله أبو القاسم	y
أبو بكر أحمد بن علي بن ثابت البغدادي الخطيب	أبو بكر أحمد بن علي بن ثابت الخطيب	y
أبو العباس أحمد بن خالد بن محمد الناصري	شهاب الدين أبو العباس أحمد بن خالد بن محمد الناصري الدرعي الجعفري السلاوي (المتوفى: 1315هـ)	y
أبو الفضل أحمد بن علي بن محمد بن أحمد بن حجر العسقلاني (المتوفى: 852هـ)	أحمد بن علي بن حجر	y
أبو المجد اسعد بن إبراهيم الشيباني الإربلي المعروف بمجد الدين النشابي الكاتب (المتوفى : 657هـ)	الشيباني	n
ابن الأثير الجزري	عز الدين بن الأثير أبي الحسن علي بن محمد الجزري	y
أبو إسحاق إبراهيم بن علي الشيرازي	أبي إسحاق إبراهيم بن علي الشيرازي	y
أبو الحسين عبد الباقي بن قانع بن مرزوق بن واثق الأموي بالولاء البغدادي (المتوفى: 351هـ)	عبد الباقي بن قانع أبو الحسين	y
أبو الفتح محمد بن الحسين بن أحمد بن عبد الله بن بريدة الموصلي الأزدي (المتوفى: 374هـ)	محمد بن الحسين الأزدي أبو الفتح	y
جمال الدين أبي الفرج عبد الرحمن بن الجوزي	عبد الرحمن بن علي بن الجوزي	y
أبو القاسم الحسن بن محمد بن حبيب النيسابوري (المتوفى : 406هـ)	أبو القاسم الحسن بن محمد بن حبيب النيسابوري (المتوفى: 406هـ)	y
تقي الدين السبكي	علي بن عبد الكافي السبكي	y
أبو الحسن علي بن محمد الماوردي الشافعي	أبو الحسن علي بن محمد بن حبيب البصري البغدادي الماوردي	y
بدر الدين، أبو البركات محمد بن محمد بن محمد الغزي (المتوفى: 984هـ)	محمد بن محمد بن محمد الغزي العامري الدمشقي، أبو البركات، بدر الدين ابن رضي الدين (المتوفى: 984هـ)	y
أحمد بن الحسين بن علي بن موسى الخسروجردي الخراساني، أبو بكر البيهقي (المتوفى : 458هـ)	الحافظ الامام أبو بكر أحمد بن الحسين بن علي بن موسى أبو أحمد. البيهقي. الخسروجردي	y
آل تيمية [بدأ بتصنيفها الجد: مجد الدين عبد السلام بن تيمية (ت: 652هـ)، وأضاف إليها الأب،: عبد الحليم بن تيمية (ت: 682هـ)، ثم أكملها الابن الحفيد: أحمد بن تيمية (728هـ)]	أحمد بن تيمية	n
أبو القاسم البغوي	عبد الله بن محمد البغوي	y
أبو الفرج عبد الرحمن بن أحمد بن رجب الحنبلي	عبد الرحمن بن أحمد بن رجب الحنبلي	y
أبو الحسن الدارقطني	أبو الحسن علي بن عمر بن أحمد بن مهدي بن مسعود بن النعمان بن دينار البغدادي الدارقطني (المتوفى : 385هـ)	y
أبي إسحاق إبراهيم بن علي الشيرازي	إبراهيم بن علي بن يوسف الفيروزأبادي الشيرازي أبو إسحاق	y
الآمدي	علي بن أبي علي بن محمد بن سالم الآمدي	y
أبو الوليد محمد بن أحمد بن رشد القرطبي (المتوفى: 520هـ)	محمد بن أحمد بن محمد بن رشد القرطبي أبو الوليد	y
أبو الحسين عبد الصمد بن علي بن محمد بن مكرم البغدادي، الطستي، الوكيل (المتوفى: 346هـ)	البغدادي	n
أبو بكر عبد الله بن محمد بن أبي الدنيا	أبو بكر عبد الله بن محمد بن عبيد ابن أبي الدنيا القرشي البغدادي	y
أبو منصور عبد الملك بن محمد بن إسماعيل الثعالبي	عبد الملك بن محمد بن إسماعيل أبو منصور الثعالبي	y
سليمان بن أحمد بن أيوب أبو القاسم الطبراني	سليمان بن أحمد بن أيوب الطبراني أبو القاسم	y
أبو العباس أحمد بن محمد بن علي ابن حجر الهيثمي	أحمد بن علي بن حجر	n
أبي منصور عبد الملك بن محمد بن إسماعيل الثعالبي	الثعالبي	y
أبو بكر بن أحمد بن محمد بن عمر الأسدي الشهبي الدمشقي، تقي الدين ابن قاضي شهبة (المتوفى: 851هـ)	أبو بكر بن أحمد بن محمد بن عمر بن قاضي شهبة	y
أبو بكر أحمد بن سلمان بن الحسن بن إسرائيل بن يونس النجاد (المتوفى : 348هـ)	أبو بكر النجاد، أحمد بن سلمان بن الحسن بن إسرائيل بن يونس البغدادي (المتوفى: 348هـ)	y
أبو السري هناد بن السري بن مصعب بن أبي بكر بن شبر بن صعفوق بن عمرو بن زرارة بن عدس بن زيد التميمي الدارمي الكوفي (المتوفى: 243هـ)	هناد بن السري الكوفي	y
أبي الفرج عبد الرحمن بن الجوزي	جمال الدين أبو الفرج عبد الرحمن بن علي بن محمد الجوزي (المتوفى: 597هـ)	y
أبو القاسم الحسن بن بشر الآمدي (المتوفى: 370 هـ)	الآمدي	n
أبو الحسنات محمد عبد الحي اللكنوي الهندي	محمد عبد الحي بن محمد عبد الحليم الأنصاري اللكنوي الهندي، أبو الحسنات (المتوفى: 1304هـ)	y
أحمد بن علي بن عبد القادر، أبو العباس الحسيني العبيدي، تقي الدين المقريزي (المتوفى: 845هـ)	تقي الدين أبي العباس أحمد بن علي بن عبد القادر العبيدي المقريزي	y
أبو الفرج عبد الرحمن بن أحمد بن رجب الحنبلي (المتوفى: 795هـ)	عبد الرحمن بن أحمد بن رجب الحنبلي (المتوفى : 795هـ)	y
أبو العباس أحمد بن محمد بدر الدين ابن محمد شمس الدين ابن علي نور الدين ابن حجر الهيتمي	الهيتمي	y
أبي إسحاق إبراهيم بن علي الشيرازي	إبراهيم بن علي بن يوسف الفيروزآبادي الشيرازي أبو إسحاق	y
جمال الدين أبو الفرج عبد الرحمن بن علي بن محمد الجوزي (المتوفى: 597هـ) (منسوب خطأ في المطبوع لابن قيم الجوزية)	عبد الرحمن بن علي بن محمد بن الجوزي أبو الفرج	y
أبو الفرج عبد الرحمن بن علي الجوزي	عبد الرحمن بن الجوزي أبو الفرج	y
أبو الحسن بن عبد الله بن الحسن النباهي المالقي الأندلسي	عبد الله بن محمد الأندلسي أبو محمد	n
أحمد بن علي بن ثابت البغدادي أبو بكر	الخطيب البغدادي	y
(اختصار وتحقيق) محمد علي الصابوني	محمد علي الصابوني	y
أبو القاسم حمزة بن يوسف بن إبراهيم السهمي القرشي الجرجاني (المتوفى: 427هـ)	الجرجاني	m
أبو محمد الحسن بن عبد الرحمن بن خلاد الرامهرمزي الفارسي (المتوفى: 360هـ)	الحسن بن عبد الرحمن الرامهرمزي	y
أبو الحسن على بن موسى بن سعيد المغربي (المتوفى : 685هـ)	أبو الحسن على بن موسى بن سعيد المغربي الأندلسي (المتوفى: 685هـ)	y
أبو بكر أحمد بن الحسين البيهقي	أحمد بن الحسين البيهقي أبو بكر	y
أبو بكر عبد الله بن محمد بن أبي الدنيا	أبو بكر عبد الله بن محمد بن عبيد بن أبي الدنيا (المتوفى : 281هـ)	y
أبو الحسن سيد الدين علي بن أبي علي بن محمد بن سالم الثعلبي الآمدي (المتوفى: 631هـ)	علي بن أبي علي بن محمد بن سالم الآمدي	y
أبو الفرج عبد الرحمن بن الجوزي الحنبلي	أبي الفرج عبد الرحمن بن الجوزي	y
أبو الفرج عبد الرحمن بن أبي الحسن الجوزي	جمال الدين أبو الفرج عبد الرحمن بن علي بن محمد الجوزي (المتوفى: 597هـ) (منسوب خطأ في المطبوع لابن قيم الجوزية)	y
أبو الحسن الدارقطني	علي بن عمر أبو الحسن الدارقطني	y
أبو الوليد سليمان بن خلف بن سعد بن أيوب بن وارث التجيبي القرطبي الباجي الأندلسي (المتوفى: 474هـ)	سليمان بن خلف الباجي	y
أبو الفرج عبد الرحمن بن الجوزي	جمال الدين أبي الفرج عبد الرحمن ابن الجوزي	y
الثعالبي	عبد الملك بن محمد بن إسماعيل أبو منصور الثعالبي (المتوفى: 429هـ)	y
أبو الحسن سيد الدين علي بن أبي علي بن محمد بن سالم الثعلبي الآمدي (المتوفى: 631هـ)	الثعلبي	n
أبو يعلى الخليلي، خليل بن عبد الله بن أحمد بن إبراهيم بن الخليل القزويني (المتوفى: 446هـ)	أحمد بن عبد الله العمري	n
عبد الملك بن عبد الله بن يوسف الجويني أبو المعالي	عبد الملك بن عبد الله بن يوسف بن محمد الجويني، أبو المعالي، ركن الدين، الملقب بإمام الحرمين (المتوفى: 478هـ)	y
أبو بكر أحمد بن موسى بن العباس بن مجاهد البغدادي	أحمد بن موسى بن العباس التميمي، أبو بكر بن مجاهد البغدادي (المتوفى: 324هـ)	y
آل تيمية [بدأ بتصنيفها الجد: مجد الدين عبد السلام بن تيمية (ت: 652هـ)، وأضاف إليها الأب،: عبد الحليم بن تيمية (ت: 682هـ)، ثم أكملها الابن الحفيد: أحمد بن تيمية (728هـ)]	أحمد بن عبد الحليم بن تيمية	n
أبو الفضل القاضي عياض بن موسى اليحصبي (المتوفى: 544هـ)	القاضي عياض	y
أبو الفرج عبد الرحمن بن علي بن محمد القرشي	أبي الفرج عبد الرحمن بن الجوزي	y
أبو الفرج عبد الرحمن ابن الجوزي	جمال الدين أبي الفرج عبد الرحمن بن الجوزي	y
أبو الحسين العالي، أحمد بن محمد بن منصور العالي البوشنجي (المتوفى: 419هـ)	محمد بن أحمد بن الحسين	n
أبو الحسن علي بن محمد بن حبيب البصري البغدادي الماوردي	البغدادي	n
أبو الفرج عبد الرحمن بن أبي الحسن الجوزي	جمال الدين أبو الفرج عبد الرحمن بن علي بن محمد الجوزي (المتوفى: 597هـ)	y
أبو الحسن علي بن عيسى بن علي بن عبد الله الرماني	علي بن عيسى بن علي بن عبد الله، أبو الحسن الرماني المعتزلي (المتوفى: 384هـ)	y
أبو بكر أحمد بن إبراهيم الإسماعيلي	أحمد بن إبراهيم بن إسماعيل الإسماعيلي أبو بكر	y
أبو القاسم الحسين بن محمد	أبو القاسم الحسين بن محمد بن المفضل الأصفهاني	y
أبو بكر بن علي بن محمد الحدادي العبادي الزبيدي اليمني الحنفي (المتوفى: 800هـ)	أبو بكر بن علي بن محمد الحدادي العبادي اليمني - الزبيدي (المتوفى : 800هـ)	y
أبو الفرج عبد الرحمن بن علي بن الجوزي	ابو الفرج عبد الرحمن بن علي بن الجوزي	y
أبو الحسن علي بن محمد بن محمد بن حبيب البصري البغدادي، الشهير بالماوردي (المتوفى: 450هـ)	البغدادي	n
أبو الفرج عبد الرحمن بن علي بن الجوزي	عبد الرحمن بن علي بن محمد بن الجوزي أبو الفرج	y
أبو الفرج عبد الرحمن ابن الجوزي	عبد الرحمن بن علي بن محمد أبو الفرج	y
الهيثمي	علي بن أبي بكر الهيثمي أبو الحسن	y
سليمان بن أحمد الطبراني أبو القاسم	سليمان بن أحمد بن أيوب بن مطير اللخمي الشامي، أبو القاسم الطبراني (المتوفى: 360هـ)	y
أبو الحسن علي بن عمر بن أحمد بن مهدي بن مسعود بن النعمان بن دينار البغدادي الدارقطني (المتوفى: 385هـ)	علي بن عمر أبو الحسن الدارقطني	y
أبو بكر أحمد بن علي بن ثابت البغدادي الخطيب	البغدادي	n
أبو الفرج عبد الرحمن ابن الجوزي	أبو الفرج عبد الرحمن بن علي بن محمد بن علي بن عبيد الله بن عبد الله بن هادي بن أحمد بن محمد بن جعفر الجوزي	y
أبو الفداء إسماعيل بن عمر بن كثير القرشي الدمشقي (المتوفى : 774هـ)	إسماعيل بن عمر بن كثير الدمشقي أبو الفداء	y
أبو الحسن علي بن أحمد بن محمد بن علي الواحدي، النيسابوري، الشافعي (المتوفى: 468هـ)	الواحدي	y
أبو عبد الله محمد بن فتوح بن عبد الله الحميدي (المتوفى : 488هـ)	محمد بن عبد الله دراز (المتوفى: 1377هـ)	n
أحمد بن علي أبو بكر الخطيب البغدادي	أحمد بن علي بن ثابت الخطيب البغدادي	y
أبو بكر عبد الله ابن الشيخ أبي منصور محمد ابن الشيخ الكبير أبي الحسين أحمد بن محمد بن عبد الله بن النقور البغدادي، البزاز (المتوفى: 565هـ)	محمد بن أحمد بن الحسين	n
أبو بكر أحمد بن علي بن ثابت الخطيب البغدادي	أحمد بن علي بن ثابت الخطيب البغدادي	y
أبو العز محمد بن المختار بن محمد بن عبد الواحد ابن عبد الله بن المؤيد بالله الهاشمي، العباسي، البغدادي ويعرف: بابن الخص (المتوفى: 508هـ)	البغدادي	n
الدارقطني	علي بن عمر أبو الحسن الدارقطني البغدادي	y
أبو الفداء زين الدين أبو العدل قاسم بن قطلوبغا السودوني (نسبة إلى معتق أبيه سودون الشيخوني) الجمالي الحنفي (المتوفى: 879هـ)	أبو الفداء زين الدين قاسم بن قطلوبغا السودوني	y
أبو القاسم محمود بن عمرو بن أحمد، الزمخشري جار الله (المتوفى: 538هـ)	جار الله الزمخشري	y
أبو الفداء إسماعيل بن عمر بن كثير القرشي البصري ثم الدمشقي (المتوفى: 774هـ)	أبو الفداء إسماعيل بن عمر بن كثير القرشي الدمشقي (المتوفى: 774هـ)	y
أبو الليث السمرقندي	نصر بن محمد بن أحمد أبو الليث السمرقندي	y
ابن الجوزي	عبد الرحمن بن علي بن محمد بن الجوزي أبو الفرج	y
أحمد بن علي بن ثابت الخطيب البغدادي أبو بكر	الخطيب البغدادي	y
أبو الوليد محمد بن أحمد بن محمد بن أحمد بن رشد القرطبي الشهير بابن رشد الحفيد (المتوفى : 595هـ)	القرطبي	n
علي بن عمر بن أحمد الدارقطني	علي بن عمر بن أحمد الدارقطني أبو الحسن	y
أبو اسحاق إبراهيم بن علي الشيرازي (المتوفى: 476هـ)	إبراهيم بن علي بن يوسف الفيروزآبادي الشيرازي أبو إسحاق	y
أبو العباس، أحمد بن عبد الله بن محمد، محب الدين الطبري (المتوفى: 694هـ)	الطبري	n
أحمد بن علي بن حجر	أحمد بن علي بن حجر العسقلاني	y
أبو الفضل عبد الرحمن بن أحمد بن الحسن بن بندار العجلي الرازي المقرئ	المقرئ	m
- :: ناصر بن عبد الكريم العقل	د. ناصر بن عبد الكريم العقل	y
ثقة الدين، أبو القاسم علي بن الحسن بن هبة الله المعروف بابن عساكر (المتوفى: 571هـ)	علي بن الحسن بن هبة الله أبو القاسم	y
أبو بكر أحمد بن الحسين البيهقي	البيهقي	y
أبو الحسن علي بن عمر بن أحمد الدارقطني	علي بن عمر بن أحمد الدارقطني	y
أبو القاسم تمام بن محمد بن عبد الله بن جعفر بن عبد الله بن الجنيد البجلي الرازي ثم الدمشقي (المتوفى: 414هـ)	تمام بن محمد الرازي أبو القاسم	y
أبو القاسم محمود بن عمر الزمخشري الخوارزمي	أبو القاسم محمود بن عمر بن محمد بن عمر الخوارزمي الزمخشري	y
أبو بكر أحمد بن علي بن ثابت الخطيب	أبو بكر أحمد بن علي بن ثابت الخطيب البغدادي	y
أحمد بن عبد الله العمري	عبد القادر بن محمد بن أحمد بن الحسين اليونيني، محيي الدين ابن الحافظ شرف الدين ابن الفقيه أبي عبد الله اليونيني (المتوفى: 747هـ)	n
السيوطي	جلال الدين السيوطي	y
أبو بكر أحمد بن علي بن ثابت البغدادي الخطيب	أحمد بن علي أبو بكر الخطيب البغدادي	y
أبو بكر بن أبي داود السجستاني عبد الله بن بن سليمان بن الأشعث	سليمان بن الأشعث	m
ابن الجوزي	عبد الرحمن بن علي بن محمد الجوزي	y
أبو بكر أحمد بن علي بن ثابت بن أحمد بن مهدي الخطيب البغدادي (المتوفى: 463هـ)	أحمد بن علي بن ثابت الخطيب البغدادي أبو بكر	y
أبو بكر أحمد بن علي بن ثابت الخطيب البغدادي (المتوفى: 463هـ)	أحمد بن علي بن ثابت الخطيب البغدادي	y
جمال الدين أبو الفرج عبد الرحمن بن علي بن محمد الجوزي (المتوفى: 597هـ)	عبد الرحمن بن علي بن محمد أبو الفرج	y
عمرو بن أبي عاصم	عمرو بن أبي عاصم الضحاك الشيباني	y
أبو الحسن علي بن عمر بن أحمد بن مهدي بن مسعود بن النعمان بن دينار البغدادي الدارقطني (المتوفى: 385هـ)	علي بن عمر الدارقطني	y
الطبراني	سليمان بن أحمد بن أيوب بن مطير اللخمي الشامي، أبو القاسم الطبراني (المتوفى: 360هـ)	y
أبو بكر جعفر بن محمد بن الحسن بن المستفاض الفريابي (المتوفى: 301هـ)	جعفر بن محمد بن الحسن الفريابي	y
أبو بكر محمد بن الطيب الباقلاني	محمد بن الطيب الباقلاني	y
أبو بكر أحمد بن علي بن ثابت الخطيب البغدادي	الخطيب البغدادي	y
ابو الفرج عبد الرحمن بن علي بن الجوزي	جمال الدين أبي الفرج عبد الرحمن بن الجوزي	y
الأنصاري الهروي	عبد الله الأنصاري الهروي	y
عبد الرحيم العراقي	عبد الرحيم بن الحسين العراقي أبو الفضل	y
أبو القاسم، محمد بن أحمد بن محمد بن عبد الله، ابن جزي الكلبي الغرناطي (المتوفى: 741هـ)	محمد بن أحمد بن جزي الكلبي الغرناطي	y
أبو بكر بن الحسين بن عمر، القرشي العبشمي الأموي العثماني، زين الدين، وكنيته أبو محمد ويقال اسمه (عبد الله) والمشهور (أبو بكر) المصري الشافعي المراغي (المتوفى: 816هـ)	القرشي المصري	n
أبو بكر أحمد بن علي بن ثابت بن أحمد بن مهدي الخطيب البغدادي (المتوفى: 463هـ)	أحمد بن علي بن ثابت أبو بكر الخطيب البغدادي	y
أبو القاسم محمود بن عمر الزمخشري الخوارزمي	الزمخشري	y
أحمد بن الحسين بن علي بن موسى الخسروجردي الخراساني، أبو بكر البيهقي (المتوفى : 458هـ)	أحمد بن الحسين بن علي بن موسى الخسروجردي الخراساني، أبو بكر البيهقي (المتوفى: 458هـ)	y
أحمد بن علي بن ثابت أبو بكر الخطيب البغدادي	الخطيب البغدادي	y
صديق بن حسن القنوجي	صديق بن حسن بن علي القنوجي	y
أبو الفرج عبد الرحمن بن الجوزي الحنبلي	عبد الرحمن بن علي بن الجوزي	y
أبو بكر أحمد بن علي بن الحسين بن زكريا الطريثيثي، ثم البغدادي، الصوفي، المعروف: بابن زهراء (المتوفى: 497هـ)	البغدادي	n
أبي الفرج عبد الرحمن بن الجوزي	عبد الرحمن بن علي بن محمد الجوزي	y
أبو بكر القاسم بن زكريا بن يحيى البغدادي، المعروف: بالمطرز (المتوفى: 305هـ)	البغدادي	n
أبي الفرج عبد الرحمن بن الجوزي	عبد الرحمن بن علي بن الجوزي	y
أبو الفضل عبد الرحمن جلال الدين السيوطي	جلال الدين عبد الرحمن السيوطي	y
[ينسب لـ] عبد الملك بن محمد بن إسماعيل أبو منصور الثعالبي (المتوفى: 429هـ)	أبو منصور الثعالبي	y
أبو بكر بن المقرئ (المتوفى: 381هـ)	المقرئ	n
محمد بن طاهر المقدسي أبو الفضل	محمد بن طاهر بن علي بن القيسراني	y
أبو الفرج عبد الرحمن بن علي بن الجوزي	جمال الدين أبو الفرج عبد الرحمن بن علي بن محمد الجوزي (المتوفى: 597هـ) (منسوب خطأ في المطبوع لابن قيم الجوزية)	y
أبو الخير محمد بن عبد الرحمن بن محمد السخاوي	شمس الدين أبو الخير محمد بن عبد الرحمن السخاوي (المتوفى : 902هـ)	y
ابن الخطيب	محمد بن قاسم بن يعقوب الأماسي الحنفي، محيي الدين، ابن الخطيب قاسم (المتوفى: 940هـ)	n
أبو الفداء زين الدين أبو العدل قاسم بن قطلوبغا السودوني (نسبة إلى معتق أبيه سودون الشيخوني) الجمالي الحنفي (المتوفى: 879هـ)	أبو الفداء زين الدين قاسم بن قطلوبغا السودوني (نسبة إلى معتق أبيه سودون الشيخوني) الجمالي الحنفي (المتوفى: 879هـ)	y
آية الله العظمى السيد محمد سعيد الطباطبائي الحكيم	السيد الطباطبائي	m
أبو القاسم محمود بن عمر الزمخشري	أبو القاسم محمود بن عمرو بن أحمد، الزمخشري جار الله (المتوفى : 538هـ)	y
أبو البركات عبد الرحمن بن محمد بن أبي سعيد الأنباري النحوي	عبد الرحمن بن محمد بن عبيد الله الأنصاري، أبو البركات، كمال الدين الأنباري (المتوفى: 577هـ)	y
أبو ذر عبيد بن أحمد بن محمد بن عبد الله بن غفير بن محمد الأنصاري الخراساني الهروي (المتوفى: 434هـ)	أحمد بن عبد الله العمري	n
أبو بكر أحمد بن الحسين بن علي بن عبد الله البيهقي	أبو بكر أحمد بن الحسين بن علي بن موسى البيهقي	y
أبو المنذر هشام بن محمد أبي النضر ابن السائب ابن بشر الكلبي (المتوفى: 204هـ)	هشام بن محمد بن السائب الكلبي (المتوفى : 204هـ)	y
أبو الفضل محمد بن طاهر بن علي بن أحمد المقدسي الشيباني، المعروف بابن القيسراني (المتوفى: 507هـ)	محمد بن طاهر بن علي المقدسي أبو الفضل	y
أبو القاسم الحسين بن محمد	أبو القاسم الحسين بن محمد المعروف بالراغب الاصفهانى (المتوفى : 502هـ)	y
أبو القاسم هبة الله بن جعفر بن سناء الملك الكاتب (المتوفى : 608هـ)	أبو القاسم هبة الله بن جعفر بن سناء الملك الكاتب (المتوفى: 608هـ)	y
أبو القاسم شهاب الدين عبد الرحمن بن إسماعيل بن إبراهيم المقدسي الدمشقي المعروف بأبي شامة (المتوفى: 665هـ)	عبد الرحمن بن إسماعيل بن إبراهيم المقدسي أبو شامة	y
أبو الفضل أحمد بن الحسين بن يحيى بديع الزمان الهمذاني (المتوفى: 398هـ)	بديع الزمان الهمذاني	m
أبو بكر أحمد بن الحسين بن علي بن عبد الله البيهقي	أحمد بن الحسين بن علي بن موسى أبو بكر البيهقي	y
أبو الحسن علي بن محمد بن محمد بن حبيب البصري البغدادي، الشهير بالماوردي (المتوفى : 450هـ)	أبو الحسن علي بن محمد بن محمد بن حبيب البصري البغدادي، الشهير بالماوردي (المتوفى: 450هـ)	y
أبو الحسن بن عبد الرحمن بن خلاد الرامهرمزي	الرامهرمزي	y
أبو بكر أحمد بن علي بن ثابت الخطيب البغدادي (المتوفى: 463هـ)	أحمد بن علي بن ثابت الخطيب البغدادي أبو بكر	y
أبو الفرج عبد الرحمن بن الجوزي	عبد الرحمن بن علي بن الجوزي	y
أحمد بن علي أبو بكر الخطيب البغدادي	أحمد بن علي بن ثابت الخطيب البغدادي أبو بكر	y
أبو الحسن علي بن عمر بن محمد ابن الحسن بن شاذان الحميري البغدادي الحربي (المتوفى : 386هـ)	الحربي	n
الواحدي	الواحدي النيسابوري	y
أبو الحسن علي بن أبي الكرم محمد بن محمد الشيباني الجزري	عز الدين بن الأثير أبي الحسن علي بن محمد الجزري	y
أحمد بن عمرو بن أبي عاصم الشيباني أبو بكر	أحمد بن عمرو بن أبي عاصم الضحاك أبو بكر	y
[ينسب لـ] عبد الملك بن محمد بن إسماعيل أبو منصور الثعالبي (المتوفى: 429هـ)	عبد الملك بن محمد بن إسماعيل أبو منصور الثعالبي (المتوفى : 429هـ)	y
أبو الفرج عبد الرحمن بن الجوزي	ابو الفرج عبد الرحمن بن علي بن الجوزي	y
أبو الحسن علي بن عمر بن أحمد الدارقطني	علي بن عمر بن أحمد بن مهدي أبو الحسن الدارقطني البغدادي	y
أبو القاسم خلف بن عبد الملك بن بشكوال (المتوفى : 578هـ)	أبو القاسم خلف بن عبد الملك بن بشكوال (المتوفى: 578 هـ)	y
أبو المعالي محمود شكري بن عبد الله بن محمد بن أبي الثناء الألوسي (المتوفى : 1342هـ)	أبو المعالي محمود شكري بن عبد الله بن محمد بن أبي الثناء الألوسي (المتوفى: 1342هـ)	y
أبو الفرج عبد الرحمن بن علي بن الجوزي	أبو الفرج عبد الرحمن بن علي بن محمد بن علي بن الجوزي	y
أبو الحسن علي بن أبي الكرم محمد بن محمد الشيباني الجزري	الشيباني	n
أبو الوليد محمد بن أحمد بن محمد بن أحمد بن رشد القرطبي الشهير بابن رشد الحفيد (المتوفى: 595هـ)	محمد بن أحمد بن أحمد بن رشد القرطبي أبو الوليد	y
أبو الحسن علي بن حبيب الماوردي	أبو الحسن علي بن محمد بن حبيب الماوردي البصري	y
علي بن عمر أبو الحسن الدارقطني	علي بن عمر أبو الحسن الدارقطني البغدادي	y
أحمد بن عمرو بن أبي عاصم الشيباني	أحمد بن عمرو بن الضحاك أبو بكر الشيباني	y
أبو بكر أحمد بن محمد بن هارون بن يزيد الخلال	أبو بكر أحمد بن محمد بن هارون بن يزيد الخلال البغدادي الحنبلي (المتوفى: 311هـ)	y
علي بن عمر بن أحمد الدارقطني أبو الحسن	علي بن عمر بن أحمد بن مهدي أبو الحسن الدارقطني البغدادي	y
عبد الله بن عدي	عبد الله بن عدي الجرجاني أبو أحمد	y
أبو الفرج عبد الرحمن بن أبي الحسن الجوزي	أبو الفرج عبد الرحمن بن علي بن محمد القرشي	y
سليمان بن أحمد بن أيوب الطبراني أبو القاسم	سليمان بن أحمد بن أيوب بن مطير اللخمي الشامي، أبو القاسم الطبراني (المتوفى : 360هـ)	y
أبو بكر أحمد بن محمد بن هارون بن يزيد الخلال البغدادي الحنبلي (المتوفى: 311هـ)	البغدادي	n
عبد الله بن سليمان الأشعث أبو بكر	عبد الله بن سليمان السجستاني	y
أبو القاسم الحسين بن محمد المعروف بالراغب الأصفهانى (المتوفى: 502هـ)	أبو القاسم الحسين بن محمد بن المفضل الأصفهاني	y
سليمان بن خلف الباجي	سليمان بن خلف بن سعد أبو الوليد الباجي	y
أبو الحسن مقاتل بن سليمان بن بشير الأزدي بالولاء البلخي	مقاتل بن سليمان	y
أبو العباس الحسن بن سفيان بن عامر بن عبد العزيز بن النعمان بن عطاء الشيباني الخراساني النسوي (المتوفى: 303هـ)	الحسن بن سفيان النسوي	y
جمال الدين أبو الفرج عبد الرحمن بن علي بن محمد الجوزي (المتوفى: 597هـ) (منسوب خطأ في المطبوع لابن قيم الجوزية)	جمال الدين أبي الفرج عبد الرحمن ابن الجوزي	y
أبو الحسن علي بن محمد الماوردي الشافعي	الماوردي	y
جمال الدين أبو الفرج عبد الرحمن بن علي بن محمد الجوزي (المتوفى: 597هـ) (منسوب خطأ في المطبوع لابن قيم الجوزية)	عبد الرحمن بن علي بن محمد أبو الفرج	y
أبو الفضل جلال الدين عبد الرحمن أبي بكر السيوطي	أبو الفضل عبد الرحمن جلال الدين السيوطي	y
أبو بكر بن أبي عاصم وهو أحمد بن عمرو بن الضحاك بن مخلد الشيباني (المتوفى: 287هـ)	عمرو بن أبي عاصم	y
أبو القاسم البغوي	عبد الله بن محمد بن عبد العزيز بن المرزبان البغوي أبو القاسم	y
أحمد بن علي بن حجر	أحمد بن علي بن حجر أبو الفضل العسقلاني	y
جمال الدين أبي الفرج عبد الرحمن بن الجوزي	عبد الرحمن بن علي بن محمد بن الجوزي أبو الفرج	y
أبو الفضل جلال الدين عبد الرحمن أبي بكر السيوطي	الحافظ أبو الفضل جلال الدين عبد الرحمن ابن أبي بكر السيوطي	y
أبو الفرج عبد الرحمن بن علي بن الجوزي	عبد الرحمن بن علي بن محمد أبو الفرج	y
عبد الرحمن بن إسماعيل بن إبراهيم	عبد الرحمن بن إسماعيل بن إبراهيم المقدسي أبو شامة	y
أبو القاسم اسماعيل ابن محمد بن الفضل التيمي الأصبهاني	الأصبهاني	n
أبو بكر أحمد بن علي بن ثابت الخطيب البغدادي	أحمد بن علي بن ثابت البغدادي أبو بكر	y
أبو الفرج عبد الرحمن بن علي بن محمد بن علي بن عبيد الله بن عبد الله بن هادي بن أحمد بن محمد بن جعفر الجوزي	جمال الدين أبو الفرج عبد الرحمن بن علي بن محمد الجوزي (المتوفى: 597هـ) (منسوب خطأ في المطبوع لابن قيم الجوزية)	y
أبو القاسم سليمان بن أحمد الطبراني	الطبراني	y
أبو الحسن علي بن عمر بن أحمد الدارقطني	أبو الحسن علي بن عمر بن أحمد بن مهدي بن مسعود بن النعمان بن دينار البغدادي الدارقطني (المتوفى : 385هـ)	y
أبو الفضل زين الدين عبد الرحيم بن الحسين بن عبد الرحمن بن أبي بكر بن إبراهيم العراقي (المتوفى: 806هـ)	أبي الفضل زين الدين عبد الرحيم بن الحسين العراقي	y
أبو إسحاق إبراهيم بن علي الشيرازي	إبراهيم بن علي بن يوسف الشيرازي أبو إسحاق	y
الإمام الحافظ أبو بشر محمد بن أحمد بن حماد الدولابي	محمد بن أحمد الدولابي	y
أحمد بن علي بن حجر أبو الفضل العسقلاني	أحمد بن علي بن حجر العسقلاني	y
أحمد بن علي بن ثابت أبو بكر الخطيب البغدادي	أحمد بن علي بن ثابت الخطيب البغدادي أبو بكر	y
أبو إسماعيل حماد بن إسحاق بن إسماعيل بن حماد بن زيد بن درهم الأزدي البغدادي المالكي (المتوفى: 267هـ)	البغدادي	n
أبو بكر أحمد بن علي بن ثابت الخطيب البغدادي (المتوفى: 463هـ)	أبو بكر أحمد بن علي بن ثابت بن أحمد بن مهدي الخطيب البغدادي (المتوفى: 463هـ)	y
أبو الوليد محمد بن أحمد بن محمد بن أحمد بن رشد القرطبي الشهير بابن رشد الحفيد (المتوفى: 595هـ)	القرطبي	n
أبو أحمد الحسن بن عبد الله بن سعيد بن إسماعيل العسكري (المتوفى: 382هـ)	الحسن بن عبد الله العسكري أبو أحمد	y
أبو الفداء إسماعيل بن عمر بن كثير القرشي الدمشقي (المتوفى : 774هـ)	إسماعيل بن عمر بن كثير القرشي أبو الفداء	y
أحمد بن علي بن عبد القادر بن محمد المقريزي (المتوفى : 845هـ)	تقي الدين أحمد بن علي المقريزي	y
عبد الرحمن بن الجوزي أبو الفرج	عبد الرحمن بن علي بن محمد الجوزي	y
أبو أحمد الحسن بن عبد الله العسكري (المتوفى : 382هـ)	الحسن بن عبد الله بن سعيد العسكري أبو أحمد	y
ابو الفرج عبد الرحمن بن علي بن الجوزي	جمال الدين أبو الفرج عبد الرحمن بن علي بن محمد الجوزي (المتوفى: 597هـ) (منسوب خطأ في المطبوع لابن قيم الجوزية)	y
أبو القاسم محمود بن عمرو بن أحمد، الزمخشري جار الله (المتوفى : 538هـ)	الزمخشري	y
عبد الرحمن بن علي بن محمد أبو الفرج	عبد الرحمن بن علي بن محمد بن الجوزي أبو الفرج	y
أبو الفرج عبد الرحمن بن الجوزي	جمال الدين أبو الفرج عبد الرحمن بن علي بن محمد الجوزي (المتوفى: 597هـ) (منسوب خطأ في المطبوع لابن قيم الجوزية)	y
أبو بكر أحمد بن الحسين البيهقي	أبو بكر أحمد بن الحسين بن علي بن موسى البيهقي	y
أبو بكر أحمد بن الحسين البيهقي	أبو بكر أحمد بن الحسين بن علي بن عبد الله البيهقي	y
أبي منصور عبد الملك بن محمد بن إسماعيل الثعالبي	عبد الملك بن محمد بن إسماعيل أبو منصور الثعالبي (المتوفى : 429هـ)	y
أبو الحسن علي بن عبد السلام التسولي	علي بن عبد السلام بن علي، أبو الحسن التسولي المالكي (المتوفى: 1258هـ)	y
أبو منصور عبد الملك بن محمد بن إسماعيل الثعالبي	عبد الملك بن محمد بن إسماعيل أبو منصور الثعالبي (المتوفى: 429هـ)	y
علي بن عمر أبو الحسن الدارقطني	علي بن عمر بن أحمد الدارقطني	y
أبو العباس أحمد بن محمد بدر الدين ابن محمد شمس الدين ابن علي نور الدين ابن حجر الهيتمي	ابن حجر	n
أبو أحمد الحسن بن عبد الله العسكري (المتوفى : 382هـ)	الحسن بن أحمد بن عبد الله أبو علي	n
ابو الفرج عبد الرحمن بن علي بن الجوزي	عبد الرحمن بن علي بن محمد أبو الفرج	y
أبو الفرج عبد الرحمن بن علي بن محمد بن علي بن الجوزي	عبد الرحمن بن علي بن الجوزي	y
أبو عبد الله محمد بن فتوح بن عبد الله الحميدي (المتوفى : 488هـ)	عبد الله بن عدي	n
أبو اسحاق إبراهيم بن علي المعروف بالحصري القيرواني (المتوفى : 453هـ)	القيرواني	n
أبو بكر بن أبي عاصم وهو أحمد بن عمرو بن الضحاك بن مخلد الشيباني (المتوفى: 287هـ)	أحمد بن عاصم	m
أحمد بن علي بن حجر	أحمد بن علي بن محمد بن علي بن حجر العسقلاني	y
أبو بكر أحمد بن الحسين بن علي بن موسى البيهقي	أحمد بن الحسين بن علي البيهقي أبو بكر	y
أبو بكر بن أبي داود، عبد الله بن سليمان بن الأشعث الأزدي السجستاني (المتوفى: 316هـ)	سليمان بن الأشعث أبو داود السجستاني الأزدي	m
أحمد بن علي بن ثابت الخطيب البغدادي	الخطيب البغدادي	y
أبو بكر أحمد بن الحسين بن علي بن موسى البيهقي	أحمد بن الحسين بن علي بن موسى الخسروجردي الخراساني، أبو بكر البيهقي (المتوفى: 458هـ)	y
أبو القاسم البغوي	عبد الله بن محمد بن عبد العزيز البغوي أبو القاسم	y
أبو البركات بدر الدين محمد بن محمد الغزي	أبو البركات محمد بن محمد بن محمد الغزي (المتوفى : 984هـ)	y
أبو الفرج عبد الرحمن بن علي بن محمد القرشي	عبد الرحمن بن الجوزي أبو الفرج	y
أبو أحمد محمد بن أحمد بن حسين بن القاسم بن السري بن الغطريف بن الجهم العبدي الغطريفي الجرجاني (المتوفى: 377هـ)	الجرجاني	n
جمال الدين أبو الفرج عبد الرحمن بن علي بن محمد الجوزي (المتوفى: 597هـ) (منسوب خطأ في المطبوع لابن قيم الجوزية)	عبد الرحمن بن الجوزي أبو الفرج	y
الدارقطني	علي بن عمر بن أحمد بن مهدي أبو الحسن الدارقطني البغدادي	y
جمال الدين أبو الفرج عبد الرحمن بن علي بن محمد الجوزي (المتوفى: 597هـ) (منسوب خطأ في المطبوع لابن قيم الجوزية)	جمال الدين أبي الفرج عبد الرحمن بن الجوزي	y
أبو إسماعيل حماد بن إسحاق بن إسماعيل بن حماد بن زيد بن درهم الأزدي البغدادي المالكي (المتوفى: 267هـ)	حماد بن زيد البغدادي	m
أبو الفرج عبد الرحمن بن علي الجوزي	أبو الفرج عبد الرحمن بن علي بن الجوزي	y
أبو الحسين أحمد بن فارس بن زكريا (المتوفى : 395هـ)	أبو الحسين أحمد بن فارس زكريا	y
أبو أحمد بن عدي الجرجاني (المتوفى: 365هـ)	الجرجاني	n
أبو الفرج عبد الرحمن بن علي الجوزي	أبو الفرج عبد الرحمن بن علي بن محمد بن علي بن عبيد الله بن عبد الله بن هادي بن أحمد بن محمد بن جعفر الجوزي	y
أبو الفرج عبد الرحمن بن أحمد بن رجب الحنبلي	عبد الرحمن بن أحمد بن رجب الحنبلي (المتوفى: 795هـ)	y
أحمد بن علي بن حجر	أحمد بن علي بن حجر العسقلاني أبو الفضل	y
أبو العباس شمس الدين أحمد بن محمد بن إبراهيم بن أبي بكر ابن خلكان البرمكي الإربلي (المتوفى: 681هـ)	ابن خلكان	y
ابن الجوزي	ابو الفرج عبد الرحمن بن علي بن الجوزي	y
أبو أحمد الحسن بن عبد الله العسكري (المتوفى : 382هـ)	الحسن بن عبد الله العسكري أبو أحمد	y
أبو القاسم هبة الله بن الحسن بن منصور الطبري الرازي اللالكائي (المتوفى: 418هـ)	الطبري	n
أبو الفرج عبد الرحمن بن الجوزي	جمال الدين أبو الفرج عبد الرحمن بن علي بن محمد الجوزي (المتوفى: 597هـ)	y
أحمد بن محمد بن علي بن حجر الهيتمي أبو العباس	الهيتمي	y
أبو الفضل أحمد بن الحسين بن يحيى	أبو الفضل أحمد بن الحسين بن يحيى بديع الزمان الهمذاني (المتوفى: 398هـ)	y
أبا علي إسماعيل بن القاسم القالي البغدادي	أبو علي إسماعيل بن القاسم القالي البغدادي	y
أبو الحسن علي بن إسماعيل بن سيده المرسي (المتوفى: 458هـ)	أبو الحسن علي بن إسماعيل بن سيده المرسي [ت: 458هـ]	y
أبو الحسن نور الدين علي بن أبي بكر بن سليمان الهيثمي (المتوفى: 807هـ)	نور الدين علي بن أبي بكر بن سليمان الهيثمي (المتوفى: 807هـ)	y
أحمد بن الحسين البيهقي	الحافظ الامام أبو بكر أحمد بن الحسين بن علي بن موسى أبو أحمد. البيهقي. الخسروجردي	y
الحسن بن عبد الله العسكري أبو أحمد	الحسن بن عبد الله بن سعيد العسكري أبو أحمد	y
أحمد بن عبد الله العمري	شمس الدين أبي عبد الله محمد بن أحمد ابن سعيد النابلسي الدمشقي، الحلبي، المقدسي، المكي الحنبلي (المتوفى: 855هـ)	n
أبو الفرج عبد الرحمن بن علي بن الجوزي	أبي الفرج عبد الرحمن بن الجوزي	y
أبو بكر بن أبي داود، عبد الله بن سليمان بن الأشعث الأزدي السجستاني (المتوفى: 316هـ)	عبد الله بن سليمان الأشعث أبو بكر	y
أبو القاسم عبيد الله بن محمد بن أحمد بن جعفر البغدادي، السقطي (المتوفى: 406هـ)	البغدادي	n
أبو الخير محمد بن أحمد بن محمد بن عمر بن القاسم بن عبد الله بن علي بن إسحاق بن سندار الأصبهاني، المقدر، المهندس، المؤذن، الصوفي، شهر بالباغبان. (المتوفى: 559هـ)	الأصبهاني	n
أبو إسحاق إبراهيم بن إسماعيل بن أحمد بن عبد الله الطرابلسي	إبراهيم بن إسماعيل بن أحمد بن عبد الله اللواتي الأجدابي، أبو إسحاق الطرابلسي (المتوفى: نحو 470هـ)	y
أبو القاسم عبد الرحمن بن عبد الله عبد الحكم بن أعين القرشي المصري	القرشي المصري	n
أبو الحسن علي بن عمر بن أحمد بن مهدي بن مسعود بن النعمان بن دينار البغدادي الدارقطني (المتوفى : 385هـ)	علي بن عمر بن أحمد الدارقطني أبو الحسن	y
محمد بن علي الصابوني	محمد علي الصابوني	y
أبو الفرج عبد الرحمن بن علي الجوزي	جمال الدين أبي الفرج عبد الرحمن ابن الجوزي	y
أبو الحسن علي بن أبي الكرم محمد بن محمد الشيباني الجزري	ابن الأثير الجزري	y
الواحدي النيسابوري	علي بن أحمد الواحدي أبو الحسن	y
أبو الحسن علي بن أبي الكرم محمد بن محمد بن عبد الكريم بن عبد الواحد الشيباني الجزري، عز الدين ابن الأثير (المتوفى: 630هـ)	محمد بن الحسن الشيباني	n
أبو أحمد بن عدي الجرجاني (المتوفى: 365هـ)	عبد الله بن عدي الجرجاني أبو أحمد	y
أبو الحسن علي بن عمر بن أحمد بن مهدي بن مسعود بن النعمان بن دينار البغدادي الدارقطني (المتوفى : 385هـ)	أبو الحسن علي بن عمر بن أحمد بن مهدي بن مسعود بن النعمان بن دينار البغدادي الدارقطني (المتوفى: 385هـ)	y
أبو اسحاق إبراهيم بن علي بن يوسف الشيرازي (المتوفى: 476هـ)	إبراهيم بن علي بن يوسف الفيروزأبادي الشيرازي أبو إسحاق	y
أحمد بن علي أبو بكر الخطيب البغدادي	أحمد بن علي بن ثابت البغدادي أبو بكر	y
أبو الفتح تقي الدين محمد، بن أبي الحسن على، بن وهب، بن مطيع، بن أبي الطاعة، القشيري المصري	تقي الدين أبي الفتح	y
أبو بكر بن أبي داود، عبد الله بن سليمان بن الأشعث الأزدي السجستاني (المتوفى: 316هـ)	السجستاني	m
أبو بكر أحمد بن محمد بن هارون بن يزيد الخلال البغدادي (المتوفى : 311هـ)	البغدادي	n
أبو الحسن علي بن إسماعيل بن إسحاق بن سالم بن إسماعيل بن عبد الله بن موسى بن أبي بردة بن أبي موسى الأشعري (المتوفى: 324هـ)	علي بن إسماعيل الأشعري أبو الحسن	y
أبو الفضل أحمد بن علي بن محمد بن أحمد بن حجر العسقلاني (المتوفى: 852هـ)	أحمد بن علي بن حجر العسقلاني أبو الفضل	y
أبو البقاء عبد الله بن الحسين العكبري	أبو البقاء عبد الله بن الحسين بن عبد الله العكبري (المتوفى: 616هـ)	y
[ينسب لـ] عبد الملك بن محمد بن إسماعيل أبو منصور الثعالبي (المتوفى: 429هـ)	عبد الملك بن محمد بن إسماعيل أبو منصور الثعالبي (المتوفى: 429 هـ)	y
أبو البركات عبد الله بن أحمد بن محمود حافظ الدين النسفي (المتوفى: 710هـ)	النسفي	n
أبو القاسم سليمان بن أحمد الطبراني	سليمان بن أحمد بن أيوب الطبراني أبو القاسم	y
أبو الفضل محمد بن طاهر بن علي بن أحمد المقدسي الشيباني، المعروف بابن القيسراني (المتوفى: 507هـ)	محمد بن طاهر المقدسي أبو الفضل	y
أبو الفداء إسماعيل بن عمر بن كثير القرشي البصري ثم الدمشقي (المتوفى: 774هـ)	إسماعيل بن عمر بن كثير القرشي أبو الفداء	y
أبو البركات عبد الرحمن بن محمد بن أبي سعيد الأنباري النحوي	أبو البركات كمال الدين عبد الرحمن بت محمد بن عبيد الله بن أبي سعيد الأنباري	y
أحمد بن علي بن ثابت أبو بكر الخطيب البغدادي	أحمد بن علي بن ثابت البغدادي أبو بكر	y
أبو بكر أحمد بن مروان الدينوري المالكي (المتوفى: 333هـ)	الدينوري	n
أبو الفرج عبد الرحمن بن علي بن محمد بن علي بن الجوزي	ابن الجوزي	y
أبو أحمد محمد بن محمد بن أحمد بن إسحاق النيسابوري الكرابيسي المعروف بالحاكم الكبير (المتوفى: 378هـ)	محمد بن أحمد بن إسحاق	n
أبو الوليد محمد بن أحمد بن محمد بن أحمد بن رشد القرطبي الشهير بابن رشد الحفيد (المتوفى : 595هـ)	أبو الوليد محمد بن أحمد بن محمد بن أحمد بن رشد القرطبي الشهير بابن رشد الحفيد (المتوفى: 595هـ)	y
(اختصار وتحقيق) محمد علي الصابوني	محمد بن علي الصابوني	y
أبو القاسم عبيد الله بن عبد الله المعروف بابن خرداذبة (المتوفى : نحو 280هـ)	أبو القاسم عبيد الله بن عبد الله المعروف بابن خرداذبة (المتوفى: نحو 280هـ)	y
أحمد بن الحسين البيهقي	أحمد بن الحسين البيهقي أبو بكر	y
أبو بكر عبد الله بن محمد بن عبيد بن أبي الدنيا (المتوفى : 281هـ)	أبو بكر عبد الله بن محمد بن عبيد بن سفيان بن قيس البغدادي الأموي القرشي المعروف بابن أبي الدنيا (المتوفى: 281هـ)	y
أبو الفرج عبد الرحمن بن علي بن محمد بن علي بن عبيد الله بن عبد الله بن هادي بن أحمد بن محمد بن جعفر الجوزي	عبد الرحمن بن الجوزي أبو الفرج	y
أبو أحمد الحسن بن عبد الله بن سعيد بن إسماعيل العسكري (المتوفى: 382هـ)	الحسن بن أحمد بن عبد الله أبو علي	n
أبو الفضل العراقي	أبو الفضل زين الدين عبد الرحيم بن الحسين بن عبد الرحمن بن أبي بكر بن إبراهيم العراقي (المتوفى: 806هـ)	y
أبو بكر أحمد بن علي بن ثابت الخطيب البغدادي	البغدادي	n
أحمد بن الحسين بن علي بن موسى أبو بكر البيهقي	البيهقي	y
أبو بكر عبد الله بن محمد بن أبي الدنيا	أبو بكر عبد الله بن محمد بن عبيد بن سفيان بن قيس البغدادي الأموي القرشي المعروف بابن أبي الدنيا (المتوفى: 281هـ)	y
أبو الحسن علي بن محمد بن حبيب البصري البغدادي الماوردي	أبو الحسن علي بن محمد بن حبيب الماوردي البصري	y
أبو العباس شمس الدين أحمد بن محمد بن أبي بكر بن خلكان	ابن خلكان	y
أ. د. سليمان بن إبراهيم بن محمد العايد	سليمان بن إبراهيم بن محمد العايد	y
أبو العباس، أحمد بن عبد الله بن محمد، محب الدين الطبري (المتوفى: 694هـ)	محب الدين أحمد بن عبد الله الطبري (المتوفى: 694هـ)	y
علي بن عمر أبو الحسن الدارقطني البغدادي	علي بن عمر الدارقطني	y
ابن الجوزي	عبد الرحمن بن علي بن محمد أبو الفرج	y
أبو البقاء عبد الله بن الحسين بن عبد الله العكبري	أبو البقاء عبد الله بن الحسين بن عبد الله العكبري (المتوفى: 616هـ)	y
أبو الوليد إسماعيل بن محمد بن عامر بن حبيب الحميري (المتوفى : نحو 440هـ)	الحميري	n
أبو القاسم محمود بن عمر الزمخشري الخوارزمي	أبو القاسم محمود بن عمرو بن أحمد، الزمخشري جار الله (المتوفى: 538هـ)	y
السيوطي	جلال الدين أبي الفضل عبد الرحمن السيوطي	y
أبو بكر أحمد بن علي بن ثابت الخطيب	أحمد بن علي أبو بكر الخطيب البغدادي	y
أبو الحسن علي بن إبراهيم بن محمد بن عيسي بن سعد الخير الأنصاري (المتوفى: 571هـ)	محمد بن سعد	n
أبو الحسن علي بن عبد السلام التسولي	علي بن عبد السلام بن علي، أبو الحسن التسولي (المتوفى: 1258هـ)	y
أبو منصور عبد الملك عبد الملك بن محمد بن إسماعيل الثعالبي	الثعالبي	y
أبو الفرج عبد الرحمن ابن الجوزي	عبد الرحمن بن الجوزي أبو الفرج	y
أبو بكر بن أبي داود السجستاني عبد الله بن بن سليمان بن الأشعث	عبد الله بن سليمان الأشعث أبو بكر	y
أبو منصور الثعالبي	عبد الملك بن محمد بن إسماعيل أبو منصور الثعالبي (المتوفى: 429هـ)	y
أبو الفرج عبد الرحمن بن علي بن محمد بن علي بن عبيد الله بن عبد الله بن هادي بن أحمد بن محمد بن جعفر الجوزي	عبد الرحمن بن علي بن محمد الجوزي	y
أبو إسماعيل عبد الله بن محمد بن علي الأنصاري الهروي (المتوفى: 481هـ)	محمد بن علي بن حماد أبو عبد الله	n
عبد الله بن سليمان الأشعث	عبد الله بن سليمان السجستاني	y
أبو البركات	أبو البركات كمال الدين عبد الرحمن بت محمد بن عبيد الله بن أبي سعيد الأنباري	n
أبو الحسن الدارقطني	علي بن عمر أبو الحسن الدارقطني البغدادي	y
أبو الفرج عبد الرحمن بن علي بن الجوزي	أبو الفرج عبد الرحمن بن علي بن محمد بن علي بن عبيد الله بن عبد الله بن هادي بن أحمد بن محمد بن جعفر الجوزي	y
أبو بكر أحمد بن الحسين البيهقي	الحافظ الامام أبو بكر أحمد بن الحسين بن علي بن موسى أبو أحمد. البيهقي. الخسروجردي	y
أبي الحسن أحمد بن عبد الله بن صالح العجلي الكوفي نزيل طرابلس الغرب	أحمد بن عبد الله العمري	n
أبو الفضل جلال الدين عبد الرحمن أبي بكر السيوطي	جلال الدين عبد الرحمن السيوطي	y
أبو الفضل عبد الرحيم بن الحسين العراقي	عبد الرحيم بن الحسين العراقي أبو الفضل	y
أبو بكر محمد بن الحسن بن دريد الأزدي (المتوفى : 321هـ)	أبو بكر محمد بن الحسن بن دريد الأزدي (المتوفى: 321هـ)	y
أبو بكر النجاد، أحمد بن سلمان بن الحسن بن إسرائيل بن يونس البغدادي (المتوفى: 348هـ)	البغدادي	n
سليمان بن أحمد الطبراني أبو القاسم	سليمان بن أحمد بن أيوب أبو القاسم الطبراني	y
أبو الحسن الدارقطني	علي بن عمر بن أحمد الدارقطني	y
أبو إسحاق أحمد بن محمد بن إبراهيم الثعلبي النيسابوري	الثعلبي	y
الطبراني	سليمان بن أحمد بن أيوب الطبراني أبو القاسم	y
أبو بكر أحمد بن علي بن ثابت الخطيب البغدادي (المتوفى: 463هـ)	أحمد بن علي بن ثابت أبو بكر الخطيب البغدادي	y
أبو الحسن علي بن أحمد السبتي الأموي	أبو الحسن علي بن أحمد السبتي الأموي المعروف بـ «ابن خمير» (المتوفى: 614هـ)	n
أحمد بن الحسين بن علي البيهقي أبو بكر	أحمد بن الحسين بن علي بن موسى أبو بكر البيهقي	y
أبو بكر أحمد بن الحسين بن علي بن موسى البيهقي	أحمد بن الحسين البيهقي أبو بكر	y
أبو الحسن ظهير الدين علي بن زيد البيهقي، الشهير بابن فندمه (المتوفى: 565هـ)	ظهير الدين علي بن زيد البيهقي (المتوفى : 565هـ)	y
أبو الفضل أحمد بن أبي طاهر ابن طيفور (المتوفى : 280هـ)	أبو الفضل أحمد بن أبي طاهر ابن طيفور (المتوفى: 280هـ)	y
أبو اسحاق إبراهيم بن علي بن يوسف الشيرازي (المتوفى: 476هـ)	أبي إسحاق إبراهيم بن علي الشيرازي	y
أبو القاسم محمود بن عمر بن محمد بن عمر الخوارزمي الزمخشري	أبو القاسم محمود بن عمرو بن أحمد، الزمخشري جار الله (المتوفى: 538هـ)	y
الحافظ أبو الفضل جلال الدين عبد الرحمن ابن أبي بكر السيوطي	جلال الدين السيوطي	y
أبو بكر أحمد بن الحسين بن علي بن عبد الله البيهقي	البيهقي	y
أبو الحسن علي بن إسماعيل بن سيده المرسي	أبو الحسن علي بن إسماعيل بن سيده المرسي (المتوفى: 458هـ)	y
أبو أحمد عبد الله بن عدي بن عبد الله بن محمد ابن مبارك بن القطان الجرجاني (المتوفى: 365هـ)	عبد الله بن عدي الجرجاني أبو أحمد	y
عبد الرحمن بن علي بن الجوزي	عبد الرحمن بن علي بن محمد بن الجوزي أبو الفرج	y
أبو بكر أحمد بن موسى بن مردوية بن فورك بن موسى بن جعفر الأصبهاني (المتوفى: 410هـ)	الأصبهاني	n
أبو القاسم محمود بن عمر الزمخشري	أبو القاسم محمود بن عمر الزمخشري الخوارزمي	y
أبو الفضل عبد الرحمن جلال الدين السيوطي	جلال الدين أبي الفضل عبد الرحمن السيوطي	y
أبو المعالي الجويني الملقب بإمام الحرمين (المتوفى: 478هـ)	أبو المعالي عبد الملك بن عبد الله بن يوسف الجويني	y
عبد الرحمن بن الجوزي أبو الفرج	عبد الرحمن بن علي بن محمد أبو الفرج	y
أبو بكر أحمد بن الحسين بن علي بن عبد الله البيهقي	أحمد بن الحسين بن علي بن موسى الخسروجردي الخراساني، أبو بكر البيهقي (المتوفى : 458هـ)	y
أبو القاسم هبة الله بن الحسن بن منصور الطبري الرازي اللالكائي (المتوفى: 418هـ)	هبة الله بن الحسن الطبري اللالكائي	y
أ. علي بن أحمد بن الأمين الريسوني	أحمد الريسوني	n
أبو الحسن علي بن أبي الكرم محمد بن محمد بن عبد الكريم الشيباني	محمد بن الحسن الشيباني	n
أبو الفرج عبد الرحمن بن الجوزي الحنبلي	أبو الفرج عبد الرحمن بن علي بن الجوزي	y
أبو البقاء محمد بن أحمد بن محمد ابن الضياء المكي الحنفي	محمد بن أحمد بن الضياء محمد القرشي العمري المكي الحنفي، بهاء الدين أبو البقاء، المعروف بابن الضياء (المتوفى: 854هـ)	y
عبد الرحمن بن أحمد بن رجب الحنبلي	عبد الرحمن بن أحمد بن رجب الحنبلي (المتوفى : 795هـ)	y
أبو العباس أحمد بن محمد بن عيسى بن الأزهر البرتي البغدادي القاضي الحنفي (المتوفى: 280هـ)	البغدادي	n
أبو الحسن ظهير الدين علي بن زيد البيهقي ، الشهير بابن فندمه (المتوفى : 565هـ)	البيهقي	n
أبو بكر عبد الرزاق بن همام الصنعاني	عبد الرزاق الصنعاني	y
أبو العباس محمد بن يزيد المبرد	محمد بن يزيد المبرد، أبو العباس (المتوفى : 285هـ)	y
أبو الفرج عبد الرحمن بن الجوزي الحنبلي	عبد الرحمن بن علي بن محمد أبو الفرج	y
جمال الدين أبي الفرج عبد الرحمن ابن الجوزي	عبد الرحمن بن علي بن الجوزي	y
أبو الحسين ابن أبي يعلى، محمد بن محمد (المتوفى: 526هـ)	محمد بن أبي يعلى أبو الحسين	m
أبو منصور عبد الملك عبد الملك بن محمد بن إسماعيل الثعالبي	عبد الملك بن محمد بن إسماعيل أبو منصور الثعالبي	y
عبد الرحمن بن الجوزي أبو الفرج	عبد الرحمن بن علي بن الجوزي	y
أبو الفرج عبد الرحمن بن أبي الحسن الجوزي	ابو الفرج عبد الرحمن بن علي بن الجوزي	y
أبو البركات محمد بن محمد بن محمد الغزي (المتوفى : 984هـ)	بدر الدين، أبو البركات محمد بن محمد بن محمد الغزي (المتوفى: 984هـ)	y
أحمد بن الحسين البيهقي أبو بكر	أحمد بن الحسين بن علي البيهقي أبو بكر	y
أبو الفرج محمد بن إسحاق بن محمد الوراق البغدادي المعتزلي الشيعي المعروف بابن النديم (المتوفى: 438هـ)	محمد بن إسحاق أبو الفرج النديم	y
أحمد بن علي المقريزي	أحمد بن علي بن عبد القادر بن محمد المقريزي (المتوفى : 845هـ)	y
أحمد بن علي المقريزي	تقي الدين أبي العباس أحمد بن علي بن عبد القادر العبيدي المقريزي	y
أبو بكر أحمد بن سلمان بن الحسن بن إسرائيل بن يونس النجاد (المتوفى: 348هـ)	أبو بكر النجاد، أحمد بن سلمان بن الحسن بن إسرائيل بن يونس البغدادي (المتوفى: 348هـ)	y
أحمد بن حجر العسقلاني	أحمد بن علي بن حجر العسقلاني	y
أبو الفرج عبد الرحمن بن علي الجوزي	عبد الرحمن بن علي بن محمد بن الجوزي أبو الفرج	y
أحمد بن علي بن عبد القادر بن محمد المقريزي (المتوفى : 845هـ)	تقي الدين أبي العباس أحمد بن علي بن عبد القادر العبيدي المقريزي	y
أبو الفرج عبد الرحمن بن الجوزي الحنبلي	ابن الجوزي	y
أبو الطيب محمد صديق خان بن حسن بن علي ابن لطف الله الحسيني البخاري القنوجي (المتوفى: 1307هـ)	صديق حسن خان	m
أبو إسماعيل عبد الله بن محمد الأنصاري الهروي (المتوفى: 481هـ)	أبو إسماعيل عبد الله بن محمد بن علي الأنصاري الهروي (المتوفى: 481هـ)	y
أبو الفرج عبد الرحمن بن علي بن محمد بن علي بن الجوزي	جمال الدين أبو الفرج عبد الرحمن بن علي بن محمد الجوزي (المتوفى: 597هـ)	y
أبو بكر بن علي بن محمد الحدادي العبادي اليمني - الزبيدي (المتوفى : 800هـ)	الزبيدي	n
أبو بكر بن أبي عاصم وهو أحمد بن عمرو بن الضحاك بن مخلد الشيباني (المتوفى: 287هـ)	أحمد بن عمرو بن أبي عاصم الشيباني	y
أبو الفرج عبد الرحمن بن أبي الحسن الجوزي	أبو الفرج عبد الرحمن بن الجوزي	y
أبو الحسن الدارقطني	أبو الحسن علي بن عمر بن أحمد الدارقطني	y
أبو البركات بدر الدين محمد بن محمد الغزي	بدر الدين، أبو البركات محمد بن محمد بن محمد الغزي (المتوفى: 984هـ)	y
أبو أحمد الحسن بن عبد الله بن سعيد بن إسماعيل العسكري (المتوفى: 382هـ)	الحسن بن عبد الله بن سعيد العسكري أبو أحمد	y
أبو القاسم عبد الرحمن بن عبد الله عبد الحكم بن أعين القرشي المصري	أبو عبد الرحمن المصري	n
أحمد بن الحسين بن علي البيهقي أبو بكر	الحافظ الامام أبو بكر أحمد بن الحسين بن علي بن موسى أبو أحمد. البيهقي. الخسروجردي	y
أبو الفضل محمد بن طاهر بن علي بن أحمد المقدسي الشيباني، المعروف بابن القيسراني (المتوفى: 507هـ)	محمد بن أحمد المقدسي	n
أبو القاسم (أو أبو البقاء) علي بن عثمان بن محمد بن أحمد بن الحسن المعروف بابن القاصح العذري البغدادي ثم المصري الشافعي المقرئ (المتوفى: 801هـ)	البغدادي	n
أبو الفضل زين الدين عبد الرحيم العراقي (المتوفى: 806هـ)	أبو الفضل زين الدين عبد الرحيم بن الحسين بن عبد الرحمن بن أبي بكر بن إبراهيم العراقي (المتوفى: 806هـ)	y
أبو العباس أحمد بن محمد بدر الدين ابن محمد شمس الدين ابن علي نور الدين ابن حجر الهيتمي	أحمد بن علي بن حجر	n
أبو الفرج عبد الرحمن بن علي الجوزي	أبي الفرج عبد الرحمن بن الجوزي	y
أبو الحسن علي بن أبي الكرم محمد بن محمد الشيباني الجزري	أبو الحسن علي بن أبي الكرم محمد بن محمد بن عبد الكريم بن عبد الواحد الشيباني الجزري، عز الدين ابن الأثير (المتوفى: 630هـ)	y
أبو القاسم محمود بن عمر الزمخشري	أبو القاسم محمود بن عمرو بن أحمد، الزمخشري جار الله (المتوفى: 538هـ)	y
المقريزي	تقي الدين أحمد بن علي المقريزي	y
أبو المعالي الجويني الملقب بإمام الحرمين (المتوفى: 478هـ)	عبد الملك بن عبد الله بن يوسف الجويني	y
أحمد بن علي بن حجر العسقلاني	أحمد بن علي بن حجر العسقلاني أبو الفضل	y
أبو أحمد الحسن بن عبد الله العسكري (المتوفى : 382هـ)	أبو هلال الحسن بن عبد الله العسكري	n
صديق بن حسن القنوجي	محمد صديق حسن خان القنوجي	y
جمال الدين أبو الفرج عبد الرحمن بن علي بن محمد الجوزي (المتوفى: 597هـ)	جمال الدين أبي الفرج عبد الرحمن ابن الجوزي	y
أبو بكر جعفر بن محمد بن الحسن بن المستفاض الفريابي	جعفر بن محمد بن الحسن الفريابي أبو بكر	y
أحمد بن عمرو بن أبي عاصم الشيباني أبو بكر	أحمد بن عمرو بن الضحاك أبو بكر الشيباني	y
أبي الفرج عبد الرحمن بن الجوزي	جمال الدين أبو الفرج عبد الرحمن بن علي بن محمد الجوزي (المتوفى: 597هـ) (منسوب خطأ في المطبوع لابن قيم الجوزية)	y
أبو بكر بن أبي داود السجستاني عبد الله بن بن سليمان بن الأشعث	أبو بكر عبد الله بن سليمان بن الأشعث السجستاني	y
أبو الحسن علي بن محمد بن المطهر العدوي المعروف بالشمشاطي	أبو الحسن علي بن محمد بن المطهر العدوي المعروف بالشمشاطي (المتوفى: 377هـ)	y
أبو الوليد محمد بن أحمد بن محمد بن أحمد بن رشد القرطبي الشهير بابن رشد الحفيد (المتوفى: 595هـ)	محمد بن أحمد بن محمد بن رشد القرطبي أبو الوليد	y
أبو الفرج عبد الرحمن بن الجوزي	عبد الرحمن بن علي بن محمد أبو الفرج	y
أبو الفضل عبد الرحمن جلال الدين السيوطي	أبي الفضل جلال الدين عبد الرحمن السيوطي	y
أبو اسحاق إبراهيم بن محمد الفارسي الاصطخري ، المعروف بالكرخي (المتوفى : 346هـ)	أبو اسحاق إبراهيم بن محمد الفارسي الاصطخري، المعروف بالكرخي (المتوفى: 346هـ)	y
أبو البركات	أبو البركات عبد الرحمن بن محمد بن أبي سعيد الأنباري النحوي	n
أبو بكر محمد بن داود بن علي بن خلف الأصبهاني ثم البغدادي الظاهري (المتوفى : 297هـ)	أبو بكر محمد بن داود بن علي بن خلف الأصبهاني ثم البغدادي الظاهري (المتوفى: 297هـ)	y
أبو الحسن علي بن حبيب الماوردي	أبو الحسن علي بن محمد الماوردي الشافعي	y
أبو بكر أحمد بن علي بن ثابت الخطيب البغدادي	أحمد بن علي بن ثابت أبو بكر الخطيب البغدادي	y
أبو العباس أحمد بن أبي أحمد الطبري المعروف بـ ابن القاص (المتوفى: 335هـ)	أبو العباس أحمد بن أحمد الطبري	y
أبو المحاسن يوسف بن موسى الحنفي	يوسف بن موسى بن محمد، أبو المحاسن جمال الدين الملطي الحنفي (المتوفى: 803هـ)	y
أبو بكر أحمد بن محمد بن هارون بن يزيد الخلال البغدادي الحنبلي (المتوفى : 311هـ)	أبو بكر أحمد بن محمد بن هارون بن يزيد الخلال البغدادي الحنبلي (المتوفى: 311هـ)	y
أحمد بن علي بن حجر	أحمد بن علي بن محمد بن حجر العسقلاني	y
أبو بكر أحمد بن محمد بن أبي بكر بن مردويه	ابن مردويه	y
أحمد بن علي أبو بكر الخطيب البغدادي	الخطيب البغدادي	y
أبو بكر عبد الله بن أبي الدنيا	أبو بكر عبد الله بن محمد بن عبيد بن سفيان بن قيس البغدادي الأموي القرشي المعروف بابن أبي الدنيا (المتوفى: 281هـ)	y
أبو الخير محمد بن عبد الرحمن بن محمد السخاوي	شمس الدين أبو الخير محمد بن عبد الرحمن بن محمد بن أبي بكر بن عثمان بن محمد السخاوي (المتوفى: 902هـ)	y
أبو الحسن محمد بن أحمد بن طباطبا العلوي	محمد بن أحمد بن محمد بن أحمد بن إبراهيم طباطبا، الحسني العلوي، أبو الحسن (المتوفى: 322هـ)	y
أبو القاسم تمام بن محمد بن عبد الله بن جعفر بن عبد الله بن الجنيد البجلي الرازي ثم الدمشقي (المتوفى: 414هـ)	أبو تمام	n
أبو الفرج عبد الرحمن بن الجوزي الحنبلي	يوسف بن عبد الرحمن	n
زين الدين أبو الفضل عبد الرحيم بن الحسين العراقي	عبد الرحيم بن الحسين العراقي أبو الفضل	y
الثعالبي	عبد الملك بن محمد بن إسماعيل أبو منصور الثعالبي	y
أبو بشر محمد بن أحمد بن حماد بن سعيد بن مسلم الأنصاري الدولابي الرازي (المتوفى: 310هـ)	محمد بن أحمد الدولابي	y
أبو الليث نصر بن محمد بن أحمد بن إبراهيم السمرقندي (المتوفى: 373هـ)	السمرقندي	n
أبو أحمد الحسن بن عبد الله العسكري (المتوفى : 382هـ)	أبو أحمد الحسن بن عبد الله بن سعيد بن إسماعيل العسكري (المتوفى: 382هـ)	y
أبو القاسم عمر بن الحسين الخرقي	أبو القاسم عمر بن الحسين بن عبد الله الخرقي (المتوفى: 334هـ)	y
أحمد بن علي العسقلاني أبو الفضل	أحمد بن علي بن حجر أبو الفضل العسقلاني	y
عبد الرحمن بن أحمد بن رجب الحنبلي	عبد الرحمن بن أحمد بن رجب الحنبلي (المتوفى: 795هـ)	y
جمال الدين أبو الفرج عبد الرحمن بن علي بن محمد الجوزي (المتوفى: 597هـ)	جمال الدين أبو الفرج عبد الرحمن بن علي بن محمد الجوزي (المتوفى: 597هـ) (منسوب خطأ في المطبوع لابن قيم الجوزية)	y
أبو البقاء عبد الله بن الحسين العكبري	أبو البقاء عبد الله بن الحسين بن عبد الله العكبري البغدادي محب الدين (المتوفى: 616هـ)	y
أبو الفرج عبد الرحمن بن علي بن محمد القرشي	عبد الرحمن بن علي بن محمد بن الجوزي أبو الفرج	y
أبو العباس شمس الدين أحمد بن محمد بن أبي بكر بن خلكان	أبو العباس شمس الدين أحمد بن محمد بن إبراهيم بن أبي بكر ابن خلكان البرمكي الإربلي (المتوفى: 681هـ)	y
أبو أحمد، محمد بن أحمد بن محمد العماري	أبو أحمد، محمد بن أحمد بن محمد العماري، عضو الدعوة والإرشاد بوزارة الشؤون الإسلامية، بالمملكة العربية السعودية	y
أبو إسحاق إبراهيم بن إسحاق بن إبراهيم بن بشير البغدادي الحربي (المتوفى: 285هـ)	إبراهيم بن إسحاق الحربي أبو إسحاق	y
أبو إسحاق إبراهيم بن إسحاق بن إبراهيم بن بشير البغدادي الحربي (المتوفى: 285هـ)	الحربي	y
أبو الفرج عبد الرحمن بن علي بن محمد بن علي بن الجوزي	جمال الدين أبو الفرج عبد الرحمن بن علي بن محمد الجوزي (المتوفى: 597هـ) (منسوب خطأ في المطبوع لابن قيم الجوزية)	y
أبو البقاء عبد الله بن الحسين العكبري	أبو البقاء عبد الله بن الحسين بن عبد الله العكبري	y
أبو بكر أحمد بن علي بن ثابت البغدادي الخطيب	أحمد بن علي بن ثابت الخطيب البغدادي أبو بكر	y
أبو بكر بن المقرئ (المتوفى: 381هـ)	أبو بكر محمد بن إبراهيم بن علي بن عاصم بن زاذان الأصبهاني الخازن، المشهور بابن المقرئ (المتوفى: 381هـ)	y
أبو بكر عبد الله بن أبي الدنيا	أبو بكر عبد الله بن محمد بن عبيد ابن أبي الدنيا القرشي البغدادي	y
أبو العباس أحمد بن محمد بن عيسى بن الأزهر البرتي البغدادي القاضي الحنفي (المتوفى: 280هـ)	أحمد بن محمد بن عيسى البرتي	y
أبو الفرج عبد الرحمن بن أبي الحسن الجوزي	ابن الجوزي	y
أبي الفرج عبد الرحمن بن الجوزي	عبد الرحمن بن علي بن محمد أبو الفرج	y
أبو سليمان محمد بن عبد الله بن أحمد بن ربيعة بن سليمان بن خالد بن عبد الرحمن بن زبر الربعي (المتوفى: 379هـ)	أحمد بن عبد الله العمري	n
علي بن عبد السلام بن علي، أبو الحسن التسولي (المتوفى: 1258هـ)	علي بن عبد السلام بن علي، أبو الحسن التسولي المالكي (المتوفى: 1258هـ)	y
أبو أحمد بن عدي الجرجاني (المتوفى: 365هـ)	عبد الله بن عدي	y
أحمد بن عمرو بن أبي عاصم الشيباني	أحمد بن عمرو بن أبي عاصم الشيباني أبو بكر	y
أبو إسحاق إبراهيم بن علي الشيرازي	إبراهيم بن علي بن يوسف الفيروزآبادي الشيرازي أبو إسحاق	y
ابو الفرج عبد الرحمن بن علي بن الجوزي	جمال الدين أبو الفرج عبد الرحمن بن علي بن محمد الجوزي (المتوفى: 597هـ)	y
أبو القاسم محمود بن عمرو بن أحمد، الزمخشري جار الله (المتوفى: 538 هـ)	الزمخشري	y
أبو بكر أحمد بن سلمان بن الحسن بن إسرائيل بن يونس النجاد (المتوفى : 348هـ)	أبو بكر أحمد بن سلمان بن الحسن بن إسرائيل بن يونس النجاد (المتوفى: 348هـ)	y
أبو الفرج عبد الرحمن بن أبي الحسن الجوزي	أبو الفرج عبد الرحمن بن علي الجوزي	y
أبو بكر أحمد بن الحسين بن علي بن عبد الله البيهقي	أحمد بن الحسين البيهقي	y
أبو منصور عبد الملك بن محمد بن إسماعيل الثعالبي	عبد الملك بن محمد بن إسماعيل أبو منصور الثعالبي (المتوفى: 429 هـ)	y
البيهقي	الحافظ الامام أبو بكر أحمد بن الحسين بن علي بن موسى أبو أحمد. البيهقي. الخسروجردي	y
أحمد بن الحسين بن علي بن موسى أبو بكر البيهقي	أحمد بن الحسين بن علي بن موسى الخسروجردي الخراساني، أبو بكر البيهقي (المتوفى: 458هـ)	y
أ. د. وهبة بن مصطفى الزحيلي، أستاذ ورئيس قسم الفقه الإسلامي وأصوله بجامعة دمشق - كلية الشريعة	د وهبة بن مصطفى الزحيلي	y
السبكي	تقي الدين السبكي	y
أبو العرب محمد بن أحمد بن تميم بن تمام التميمي	أبو تمام	m
أحمد بن علي بن عبد القادر بن محمد المقريزي (المتوفى : 845هـ)	أحمد بن علي بن عبد القادر، أبو العباس الحسيني العبيدي، تقي الدين المقريزي (المتوفى: 845هـ)	y
أبو الوليد محمد بن أحمد بن رشد القرطبي (المتوفى: 520هـ)	القرطبي	n
أبو الحسن علي بن إسماعيل بن سيده المرسي (المتوفى: 458هـ)	علي بن إسماعيل بن سيده (المتوفى: 458هـ)	y
جمال الدين أبو الفرج عبد الرحمن بن علي بن محمد الجوزي (المتوفى: 597هـ) (منسوب خطأ في المطبوع لابن قيم الجوزية)	عبد الرحمن بن علي بن محمد الجوزي	y
أبو القاسم علي بن الحسن بن هبة الله المعروف بابن عساكر (المتوفى: 571هـ)	ثقة الدين، أبو القاسم علي بن الحسن بن هبة الله المعروف بابن عساكر (المتوفى: 571هـ) من تخريجه لشيخة الفراوي	y
أبو الفرج عبد الرحمن ابن الجوزي	أبو الفرج عبد الرحمن بن علي بن محمد بن علي بن الجوزي	y
أبو القاسم عبد الملك بن محمد بن عبد الله بن بشران بن محمد بن بشران بن مهران البغدادي (المتوفى: 430هـ)	البغدادي	n
أبو الحسن عبد العزيز بن يحيى بن مسلم بن ميمون الكناني (المتوفى : 240هـ)	أبو الحسن عبد العزيز بن يحيى بن مسلم بن ميمون الكناني المكي (المتوفى: 240هـ)	y
أبو بكر بن أبي داود السجستاني عبد الله بن بن سليمان بن الأشعث	السجستاني	m
أبو القاسم محمود بن عمر بن محمد بن عمر الخوارزمي الزمخشري	جار الله الزمخشري	y
الطبراني	سليمان بن أحمد بن أيوب أبو القاسم الطبراني	y
أبو الفرج عبد الرحمن ابن الجوزي	ابن الجوزي	y
أبو عبد الله محمد بن فتوح بن عبد الله الحميدي (المتوفى : 488هـ)	عبد العزيز عبد الله الحميدي	n
أبو عبد الله محمد بن فتوح بن عبد الله الحميدي (المتوفى : 488هـ)	محمد بن عبد الهادي أبو عبد الله	n
أبو القاسم سليمان بن أحمد الطبراني	سليمان بن أحمد بن أيوب أبو القاسم الطبراني	y
إسماعيل المزني	إسماعيل بن يحيى بن إسماعيل، أبو إبراهيم المزني (المتوفى: 264هـ)	y
أبو منصور عبد الملك بن محمد بن إسماعيل الثعالبي	عبد الملك بن محمد بن إسماعيل أبو منصور الثعالبي (المتوفى : 429هـ)	y
أبو الفتح علي بن محمد بن الحسين البستي	علي بن محمد بن الحسين بن يوسف بن محمد بن عبد العزيز البستي، أبو الفتح (المتوفى: 400هـ)	y
أبو الحارث سريج بن يونس بن إبراهيم البغدادي (المتوفى : 235هـ)	البغدادي	n
أبو الحسن على بن موسى بن سعيد المغربي (المتوفى : 685هـ)	أبو الحسن على بن موسى بن سعيد المغربي (المتوفى: 685هـ)	y
أبو إسماعيل عبد الله بن محمد الأنصاري الهروي (المتوفى: 481هـ)	الأنصاري الهروي	y
أحمد بن الحسين بن علي بن موسى أبو بكر البيهقي	أحمد بن الحسين بن علي بن موسى الخسروجردي الخراساني، أبو بكر البيهقي (المتوفى : 458هـ)	y
أبو القاسم الحسين بن محمد	أبو القاسم الحسين بن محمد بن إبراهيم بن الحسين الدمشقي، الحنائي (المتوفى: 459هـ)	n
أبو البقاء عبد الله بن الحسين بن عبد الله العكبري (المتوفى: 616هـ)	أبو البقاء عبد الله بن الحسين بن عبد الله العكبري البغدادي محب الدين (المتوفى: 616هـ)	y
الهيثمي	نور الدين علي بن أبي بكر بن سليمان الهيثمي (المتوفى: 807هـ)	y
ابو الفرج عبد الرحمن بن علي بن الجوزي	جمال الدين أبي الفرج عبد الرحمن ابن الجوزي	y
إبراهيم بن علي بن يوسف الشيرازي أبو إسحاق	إبراهيم بن علي بن يوسف الفيروزآبادي الشيرازي أبو إسحاق	y
(أمالي) محمد أنور شاه بن معظم شاه الكشميري الهندي ثم الديوبندي (المتوفى: 1353هـ)	محمد أنور شاه بن معظم شاه الكشميري الهندي (المتوفى: 1353هـ)	y
أبو الفداء إسماعيل بن عمر بن كثير القرشي البصري ثم الدمشقي (المتوفى: 774هـ)	إسماعيل بن عمر بن كثير الدمشقي أبو الفداء	y
محمد بن طاهر المقدسي	محمد بن طاهر بن علي بن القيسراني	y
أبي الفضل جلال الدين عبد الرحمن السيوطي	الحافظ أبو الفضل جلال الدين عبد الرحمن ابن أبي بكر السيوطي	y
أبو الفرج عبد الرحمن بن أبي الحسن الجوزي	جمال الدين أبي الفرج عبد الرحمن بن الجوزي	y
أحمد بن عمرو بن أبي عاصم الضحاك أبو بكر	أحمد بن عمرو بن الضحاك أبو بكر الشيباني	y
أبو الحسن علي بن عمر بن أحمد بن مهدي بن مسعود بن النعمان بن دينار البغدادي الدارقطني (المتوفى : 385هـ)	الدارقطني	y
أبو بكر بن أبي شيبة	أبي بكر عبد الله بن محمد بن أبي شيبة	y
أبي منصور عبد الملك بن محمد بن إسماعيل الثعالبي	عبد الملك بن محمد بن إسماعيل أبو منصور الثعالبي (المتوفى: 429 هـ)	y
أبو الحسن علي بن حبيب الماوردي	الماوردي	y
أبو بكر بن أبي داود، عبد الله بن سليمان بن الأشعث الأزدي السجستاني (المتوفى: 316هـ)	سليمان بن الأشعث أبو داود السجستاني	m
أبو العباس أحمد بن عبد السلام الجراوي التادلي	أبو العباس أحمد بن عبد السلام الجراوي التادلي (المتوفى: 609هـ)	y
أحمد بن أحمد بن عبد الله بن محمد، أبو العباس الغبريني (المتوفى: 714هـ)	أحمد بن عبد الله العمري	n
أبو بكر عبد القاهر بن عبد الرحمن بن محمد الفارسي الأصل، الجرجاني الدار (المتوفى: 471هـ)	الجرجاني	m
جمال الدين أبو الفرج عبد الرحمن بن علي بن محمد الجوزي (المتوفى: 597هـ)	عبد الرحمن بن علي بن محمد الجوزي	y
أبو المعالي عبد الملك بن عبد الله بن يوسف الجويني	عبد الملك الجويني	y
سليمان بن أحمد بن أيوب أبو القاسم الطبراني	سليمان بن أحمد بن أيوب بن مطير اللخمي الشامي، أبو القاسم الطبراني (المتوفى : 360هـ)	y
أبو الحسن علي بن أبي الكرم محمد بن محمد الشيباني الجزري	أبو الحسن علي بن أبي الكرم محمد بن محمد بن عبد الكريم الشيباني	y
أبو عبد الله محمد بن داود بن الجراح (المتوفى: 296هـ)	أبو عبد الله محمد بن فتوح بن عبد الله الحميدي (المتوفى : 488هـ)	n
أبو بشر محمد بن أحمد بن حماد الدولابي	أبو بشر محمد بن أحمد بن حماد بن سعيد بن مسلم الأنصاري الدولابي الرازي (المتوفى: 310هـ)	y
أبو الفرج عبد الرحمن بن علي الجوزي	ابو الفرج عبد الرحمن بن علي بن الجوزي	y
أبي منصور عبد الملك بن محمد بن إسماعيل الثعالبي	عبد الملك بن محمد بن إسماعيل أبو منصور الثعالبي (المتوفى: 429هـ)	y
أبو الفرج عبد الرحمن بن علي بن محمد القرشي	أبو الفرج عبد الرحمن بن علي بن محمد بن علي بن عبيد الله بن عبد الله بن هادي بن أحمد بن محمد بن جعفر الجوزي	y
إبراهيم بن إسحاق الحربي أبو إسحاق	الحربي	y
أبو الحسن مقاتل بن سليمان بن بشير الأزدي البلخى (المتوفى: 150هـ)	أبو الحسن مقاتل بن سليمان بن بشير الأزدي بالولاء البلخي	y
الباقلاني	محمد بن الطيب الباقلاني	y
أبو الفرج عبد الرحمن بن الجوزي الحنبلي	جمال الدين أبو الفرج عبد الرحمن بن علي بن محمد الجوزي (المتوفى: 597هـ)	y
أبو بكر أحمد بن سلمان بن الحسن بن إسرائيل بن يونس النجاد (المتوفى : 348هـ)	أحمد بن سلمان النجاد أبو بكر	y
أبو الحسن ظهير الدين علي بن زيد بن محمد بن الحسين البيهقي، الشهير بابن فندمه (المتوفى: 565هـ)	ظهير الدين علي بن زيد البيهقي (المتوفى : 565هـ)	y
أبو إسحاق إبراهيم بن إسحاق بن إبراهيم بن بشير البغدادي الحربي (المتوفى: 285هـ)	أبو إسحاق إبراهيم بن إسحاق بن إبراهيم بن بشير بن عبد الله البغدادي الحربي (المتوفى: 285هـ)	y
شهاب الدين عبد الرحمن بن إسماعيل بن إبراهيم المقدسي الدمشقي	عبد الرحمن بن إسماعيل أبو شامة	y
أبو الفضل زين الدين عبد الرحيم العراقي (المتوفى: 806هـ)	عبد الرحيم بن الحسين العراقي أبو الفضل	y
أبو بكر عبد الرزاق بن همام بن نافع الحميري اليماني الصنعاني (المتوفى: 211هـ)	عبد الرزاق الصنعاني	y
الثعالبي	عبد الملك بن محمد بن إسماعيل أبو منصور الثعالبي (المتوفى: 429 هـ)	y
أبو الحارث الليث بن سعد بن عبد الرحمن الفهمي المصري (المتوفى: 175هـ)	الليث بن سعد بن عبد الرحمن الفهمي المصري	y
أبو الفضل عبد الرحمن بن أحمد بن الحسن الرازي المقرىء (المتوفى: 454هـ)	الرازي	n
ابن الجوزي	عبد الرحمن بن علي بن الجوزي	y
أحمد بن عبد الله العمري	أحمد بن يحيى بن فضل الله القرشي العدوي العمري، شهاب الدين (المتوفى: 749هـ)	m
أبو الحسين محمد بن المظفر بن موسى بن عيسى بن محمد البغدادي	البغدادي	n
أبو القاسم (أو أبو البقاء) علي بن عثمان بن محمد بن أحمد بن الحسن المعروف بابن القاصح العذري البغدادي ثم المصري الشافعي المقرئ (المتوفى: 801هـ)	المقرئ	n
محمد بن الطيب الباقلاني	محمد بن الطيب بن محمد بن جعفر بن القاسم، القاضي أبو بكر الباقلاني المالكي (المتوفى: 403هـ)	y
أبو الفضل العراقي	أبي الفضل زين الدين عبد الرحيم بن الحسين العراقي	y
سليمان بن أحمد بن أيوب بن مطير اللخمي الشامي، أبو القاسم الطبراني (المتوفى : 360هـ)	سليمان بن أحمد بن أيوب بن مطير اللخمي الشامي، أبو القاسم الطبراني (المتوفى: 360هـ)	y
أبو الفرج عبد الرحمن بن علي بن الجوزي	جمال الدين أبي الفرج عبد الرحمن بن الجوزي	y
أبو الحسن علي بن أبي الكرم محمد بن محمد بن عبد الكريم بن عبد الواحد الشيباني الجزري، عز الدين ابن الأثير (المتوفى: 630هـ)	ابن الأثير الجزري	y
أبو الصفا صلاح الدين خليل بن عز الدين أيبك بن عبد الله الألبكي الصفدي	صلاح الدين خليل بن أيبك الصفدي	y
عبد الله بن محمد بن عبد العزيز البغوي أبو القاسم	عبد الله بن محمد بن عبد العزيز بن المرزبان البغوي أبو القاسم	y
أبو الفرج عبد الرحمن بن الجوزي	جمال الدين أبي الفرج عبد الرحمن بن الجوزي	y
أبو الفرج عبد الرحمن بن أحمد بن رجب الحنبلي	أبو الفرج عبد الرحمن بن الجوزي الحنبلي	n
أبو الفضل محمد بن طاهر بن علي بن أحمد المقدسي الشيباني، المعروف بابن القيسراني (المتوفى: 507هـ)	محمد بن طاهر بن علي بن القيسراني	y
أبو القاسم عبد الرحمن بن عبد الله عبد الحكم بن أعين القرشي المصري	أبو عبد الله المصري	n
أحمد بن علي المقريزي	أحمد بن علي بن عبد القادر، أبو العباس الحسيني العبيدي، تقي الدين المقريزي (المتوفى: 845هـ)	y
أبو بكر عبد الرزاق بن همام بن نافع الحميري اليماني الصنعاني (المتوفى: 211هـ)	عبد الرزاق بن همام الصنعاني	y
أبو الحسن علي بن إسماعيل بن إسحاق بن سالم بن إسماعيل بن عبد الله بن موسى بن أبي بردة بن أبي موسى الأشعري (المتوفى: 324هـ)	علي بن إسماعيل بن أبي بشر الأشعري أبو الحسن	y
أبو بكر بن أبي عاصم وهو أحمد بن عمرو بن الضحاك بن مخلد الشيباني (المتوفى: 287هـ)	أحمد بن عمرو بن أبي عاصم الشيباني أبو بكر	y
جمال الدين أبي الفرج عبد الرحمن بن الجوزي	عبد الرحمن بن الجوزي أبو الفرج	y
أبو الفتح محمد بن عبد الكريم بن أبى بكر أحمد الشهرستاني (المتوفى: 548هـ)	الشهرستاني	y
أبو سعد أحمد بن محمد بن أحمد بن عبد الله بن حفص بن خليل الأنصاري الهروي الماليني (المتوفى: 412هـ)	أحمد بن عبد الله العمري	n
أبو القاسم محمود بن عمر الزمخشري	أبو القاسم محمود بن عمرو بن أحمد، الزمخشري جار الله (المتوفى: 538 هـ)	y
أحمد بن الحسين بن علي بن موسى الخسروجردي الخراساني، أبو بكر البيهقي (المتوفى: 458هـ)	الحافظ الامام أبو بكر أحمد بن الحسين بن علي بن موسى أبو أحمد. البيهقي. الخسروجردي	y
أبو القاسم، محمد بن أحمد بن محمد بن عبد الله، ابن جزي الكلبي الغرناطي (المتوفى: 741هـ)	محمد بن أحمد بن محمد الغرناطي الكلبي	y
أبو الحسن على بن موسى بن سعيد المغربي (المتوفى: 685هـ)	أبو الحسن على بن موسى بن سعيد المغربي الأندلسي (المتوفى: 685هـ)	y
أبو القاسم محمود بن عمر الزمخشري الخوارزمي	أبو القاسم محمود بن عمرو بن أحمد، الزمخشري جار الله (المتوفى: 538 هـ)	y
أبو الحسن علي بن عمر بن أحمد الدارقطني	علي بن عمر بن أحمد الدارقطني أبو الحسن	y
أبو القاسم محمود بن عمرو بن أحمد، الزمخشري جار الله (المتوفى : 538هـ)	أبو القاسم محمود بن عمرو بن أحمد، الزمخشري جار الله (المتوفى: 538هـ)	y
أبو الحسين محمد بن أحمد بن عبد الرحمن بن يحيى بن جميع الغساني الصيداوي (المتوفى: 402هـ)	محمد بن أحمد بن جميع الصيداوي أبو الحسين	y
أبو الفرج عبد الرحمن بن أبي الحسن الجوزي	عبد الرحمن بن علي بن محمد بن الجوزي أبو الفرج	y
أبو بكر أحمد بن علي بن ثابت البغدادي الخطيب	أبو بكر أحمد بن علي بن ثابت الخطيب البغدادي	y
أبو الحسيني المبارك بن عبد الجبار الطيوري بن عبد الله الصيرفي الحنبلي	عبد الله بن المبارك	n
أبو بكر أحمد بن الحسين بن علي بن عبد الله البيهقي	الحافظ الامام أبو بكر أحمد بن الحسين بن علي بن موسى أبو أحمد. البيهقي. الخسروجردي	y
أبو الفرج عبد الرحمن بن علي بن محمد بن علي بن عبيد الله بن عبد الله بن هادي بن أحمد بن محمد بن جعفر الجوزي	جمال الدين أبو الفرج عبد الرحمن بن علي بن محمد الجوزي (المتوفى: 597هـ)	y
أبو بكر أحمد بن الحسين بن علي بن موسى البيهقي	الحافظ الامام أبو بكر أحمد بن الحسين بن علي بن موسى أبو أحمد. البيهقي. الخسروجردي	y
أحمد بن عمرو بن أبي عاصم الضحاك أبو بكر	عمرو بن أبي عاصم الضحاك الشيباني	y
أبو الفرج عبد الرحمن بن علي بن محمد القرشي	جمال الدين أبو الفرج عبد الرحمن بن علي بن محمد الجوزي (المتوفى: 597هـ) (منسوب خطأ في المطبوع لابن قيم الجوزية)	y
أبو الحسن علي بن عمر بن أحمد بن مهدي بن مسعود بن النعمان بن دينار البغدادي الدارقطني (المتوفى : 385هـ)	علي بن عمر بن أحمد بن مهدي أبو الحسن الدارقطني البغدادي	y
أبو إسحاق الحويني الأثري حجازي محمد شريف	أبو إسحاق الحويني الأثري حجازي محمد شريف (بحث نهي الصحبة فقط)	y
أبو الحسن علي بن محمد الماوردي	الماوردي	y
أحمد بن عمرو بن الضحاك أبو بكر الشيباني	عمرو بن أبي عاصم الضحاك الشيباني	y
أبو بكر الباقلاني محمد بن الطيب (المتوفى: 403هـ)	الباقلاني	y
أبو الفرج عبد الرحمن بن علي بن محمد بن علي بن عبيد الله بن عبد الله بن هادي بن أحمد بن محمد بن جعفر الجوزي	عبد الرحمن بن علي بن محمد بن الجوزي أبو الفرج	y
أبو البركات	أبو البركات عبد الله بن أحمد بن محمود حافظ الدين النسفي (المتوفى: 710هـ)	n
أبو اسحاق إبراهيم بن علي الشيرازي (المتوفى: 476هـ)	أبي إسحاق إبراهيم بن علي الشيرازي	y
أبو الفضل زين الدين عبد الرحيم بن الحسين بن عبد الرحمن بن أبي بكر بن إبراهيم العراقي (المتوفى: 806هـ)	عبد الرحيم العراقي	y
جمال الدين أبي الفرج عبد الرحمن ابن الجوزي	جمال الدين أبي الفرج عبد الرحمن بن الجوزي	y
أبو الحسن تقي الدين علي بن عبد الكافي السبكي (المتوفى: 756هـ)	تقي الدين السبكي	y
عبد الرحمن بن إسماعيل أبو شامة	عبد الرحمن بن إسماعيل بن إبراهيم المقدسي أبو شامة	y
أبو المحاسن المفضل بن محمد بن مسعر التنوخي المعري (المتوفى : 442هـ)	أبو المحاسن المفضل بن محمد بن مسعر التنوخي المعري (المتوفى: 442هـ)	y
أبي الفضل زين الدين عبد الرحيم بن الحسين العراقي	عبد الرحيم العراقي	y
أحمد بن عمرو بن أبي عاصم الشيباني	الضحاك	y
أبو الفرج عبد الرحمن بن أحمد بن رجب الحنبلي (المتوفى: 795هـ)	عبد الرحمن بن أحمد بن رجب الحنبلي	y
أبو الطيب محمد صديق خان بن حسن بن علي ابن لطف الله الحسيني البخاري القنوجي (المتوفى: 1307هـ)	البخاري	n
أبو بكر عبد الرزاق بن همام الصنعاني	أبو بكر عبد الرزاق بن همام بن نافع الحميري اليماني الصنعاني (المتوفى: 211هـ)	y
أبو بكر بن أحمد بن محمد بن عمر الأسدي الشهبي الدمشقي، تقي الدين ابن قاضي شهبة (المتوفى: 851هـ)	ابن الدمشقي	n
أحمد بن الحسين البيهقي	أحمد بن الحسين بن علي بن موسى الخسروجردي الخراساني، أبو بكر البيهقي (المتوفى: 458هـ)	y
أحمد بن حجر العسقلاني	أحمد بن علي بن حجر العسقلاني أبو الفضل	y
أبو الخير محمد بن أحمد بن محمد بن عمر بن القاسم بن عبد الله بن علي بن إسحاق بن سندار الأصبهاني، المقدر، المهندس، المؤذن، الصوفي، شهر بالباغبان. (المتوفى: 559هـ)	أحمد علي عبد الله	n
أبو اسحاق بن أبي عون (المتوفى : 322هـ)	أبو اسحاق بن أبي عون (المتوفى: 322هـ)	y
أبو الليث نصر بن محمد بن أحمد بن إبراهيم السمرقندي (المتوفى: 373هـ)	نصر بن محمد بن أحمد أبو الليث السمرقندي	y
أبو الحارث علي بن حسن بن علي بن عبد الحميد الحلبي	الحلبي	m
عبد الله بن محمد البغوي	عبد الله بن محمد بن عبد العزيز بن المرزبان البغوي أبو القاسم	y
أبو الوليد محمد بن أحمد بن رشد القرطبي (المتوفى: 520هـ)	أبو الوليد محمد بن أحمد بن محمد بن أحمد بن رشد القرطبي الشهير بابن رشد الحفيد (المتوفى : 595هـ)	y
أبو البركات بدر الدين محمد بن محمد الغزي	محمد بن محمد بن محمد الغزي العامري الدمشقي، أبو البركات، بدر الدين ابن رضي الدين (المتوفى: 984هـ)	y
ثقة الدين، أبو القاسم علي بن الحسن بن هبة الله المعروف بابن عساكر (المتوفى: 571هـ)	ثقة الدين، أبو القاسم علي بن الحسن بن هبة الله المعروف بابن عساكر (المتوفى: 571هـ) من تخريجه لشيخة الفراوي	y
أحمد بن عمرو بن الضحاك أبو بكر الشيباني	عمرو بن أبي عاصم	y
أبو الفتح محمد بن الحسين بن أحمد بن عبد الله بن بريدة الموصلي الأزدي (المتوفى: 374هـ)	محمد بن أحمد بن الحسين	n
أبو بكر أحمد بن الحسين بن علي بن عبد الله البيهقي	أحمد بن الحسين بن علي بن موسى الخسروجردي الخراساني، أبو بكر البيهقي (المتوفى: 458هـ)	y
أبو العباس أحمد بن محمد بدر الدين ابن محمد شمس الدين ابن علي نور الدين ابن حجر الهيتمي	أحمد بن محمد بن علي بن حجر الهيتمي أبو العباس	y
أحمد بن علي المقريزي	المقريزي	y
أبو الحسن سيد الدين علي بن أبي علي بن محمد بن سالم الثعلبي الآمدي (المتوفى: 631هـ)	محمد الحسن الآمدي	n
أبو منصور الثعالبي	أبي منصور عبد الملك بن محمد بن إسماعيل الثعالبي	y
أبو الفضل محمد بن عبد الوهاب بن عبد اللطيف الأعرج (المتوفى: 925هـ)	محمد بن عبد الوهاب	n
أبو العلاء الحسن بن أحمد العطار الهمذاني	الحسن بن أحمد بن الحسن بن أحمد بن محمد بن سهل أبو العلاء العطار الهمذاني (المتوفى: 596هـ)	y
أبو القاسم الحسين بن محمد المعروف بالراغب الاصفهانى (المتوفى : 502هـ)	أبو القاسم الحسين بن محمد بن المفضل الأصفهاني	y
الطبراني	سليمان بن أحمد بن أيوب بن مطير اللخمي الشامي، أبو القاسم الطبراني (المتوفى : 360هـ)	y
أبو الفداء إسماعيل بن عمر بن كثير القرشي الدمشقي (المتوفى: 774هـ)	إسماعيل بن عمر بن كثير القرشي أبو الفداء	y
أبو الريحان محمد بن أحمد البيروني (المتوفى : 440هـ)	أبو الريحان محمد بن أحمد البيروني الخوارزمي (المتوفى: 440هـ)	y
أبو الفتح عثمان بن جني (المتوفى : 392هـ)	أبو الفتح عثمان بن جني الموصلي (المتوفى: 392هـ)	y
أبو القاسم عبد الله بن محمد بن عبد العزيز البغوي	البغوي	n
أبو إسحق برهان الدين محمد بن إبراهيم بن يحيى بن علي المعروف بالوطواط (المتوفى : 718هـ)	أبو إسحق برهان الدين محمد بن إبراهيم بن يحيى بن علي المعروف بالوطواط (المتوفى: 718هـ)	y
أبو الفرج عبد الرحمن بن الجوزي	أبو الفرج عبد الرحمن بن الجوزي الحنبلي	y
أبو الفرج عبد الرحمن بن الجوزي الحنبلي	جمال الدين أبي الفرج عبد الرحمن بن الجوزي	y
أبو القاسم هبة الله بن الحسن بن منصور الطبري الرازي اللالكائي (المتوفى: 418هـ)	الرازي	n
أبو أحمد الحسن بن عبد الله العسكري (المتوفى : 382هـ)	العسكري	y
أبو الفرج عبد الرحمن بن علي بن محمد القرشي	جمال الدين أبي الفرج عبد الرحمن بن الجوزي	y
أبو بكر أحمد بن الحسين بن علي بن موسى البيهقي	أحمد بن الحسين بن علي بن موسى أبو بكر البيهقي	y
أبو الفداء إسماعيل بن عمر بن كثير القرشي الدمشقي (المتوفى: 774هـ)	إسماعيل بن عمر بن كثير الدمشقي أبو الفداء	y
أبو الفضل أحمد بن علي بن محمد بن أحمد بن حجر العسقلاني (المتوفى: 852هـ)	أحمد بن علي بن حجر أبو الفضل العسقلاني	y
أبو اسحاق إبراهيم بن علي الشيرازي (المتوفى: 476هـ)	إبراهيم بن علي بن يوسف الشيرازي أبو إسحاق	y
جمال الدين أبو الفرج عبد الرحمن بن علي بن محمد الجوزي (المتوفى: 597هـ) (منسوب خطأ في المطبوع لابن قيم الجوزية)	عبد الرحمن بن علي بن الجوزي	y
أبو القاسم محمود بن عمر بن محمد بن عمر الخوارزمي الزمخشري	محمود بن عمر الزمخشري	y
أبو بكر عبد الله بن محمد بن أبي شيبة الكوفي	أبي بكر عبد الله بن محمد بن أبي شيبة	y
أبو إسحاق إبراهيم بن علي الشيرازي	أبو اسحاق إبراهيم بن علي بن يوسف الشيرازي (المتوفى: 476هـ)	y
أبو بكر أحمد بن علي بن ثابت بن أحمد بن مهدي الخطيب البغدادي (المتوفى: 463هـ)	البغدادي	n
أبو القاسم عبد الله بن محمد بن عبد العزيز بن المرزبان بن سابور بن شاهنشاه البغوي (المتوفى: 317هـ)	عبد الله بن محمد البغوي	y
أبو الحسن علي بن عمر بن أحمد الدارقطني	أبو الحسن علي بن عمر بن أحمد بن مهدي بن مسعود بن النعمان بن دينار البغدادي الدارقطني (المتوفى: 385هـ)	y
أبو الفرج عبد الرحمن ابن الجوزي	أبي الفرج عبد الرحمن بن الجوزي	y
أبو الوليد محمد بن عبد الله بن أحمد بن محمد بن الوليد بن عقبة بن الأزرق الغساني المكي المعروف بالأزرقي (المتوفى: 250هـ)	أحمد محمد عبد الله	n
أبو الحسن علي بن إسماعيل بن إسحاق بن سالم بن إسماعيل بن عبد الله بن موسى بن أبي بردة بن أبي موسى الأشعري (المتوفى: 324هـ)	علي بن إسماعيل أبو الحسن الأشعري	y
أبو بكر بن أبي داود السجستاني عبد الله بن بن سليمان بن الأشعث	أبو بكر بن أبي داود، عبد الله بن سليمان بن الأشعث الأزدي السجستاني (المتوفى: 316هـ)	y
أبو العباس، عبد الله بن محمد المعتز بالله ابن المتوكل ابن المعتصم ابن الرشيد العباسي (المتوفى: 296هـ)	ابن المعتز	m
أحمد بن الحسين بن علي البيهقي أبو بكر	أحمد بن الحسين بن علي بن موسى الخسروجردي الخراساني، أبو بكر البيهقي (المتوفى : 458هـ)	y
أبو القاسم البغوي	أبو القاسم عبد الله بن محمد بن عبد العزيز البغوي	y
أحمد بن عمرو بن أبي عاصم الشيباني أبو بكر	عمرو بن أبي عاصم	y
أبو القاسم خلف بن عبد الملك بن بشكوال (المتوفى: 578 هـ)	خلف بن عبد الملك بن بشكوال أبو القاسم	y
أبو الحسن محمد بن عبد الله بن زكريا بن حيويه النيسابوري المصري (المتوفى : 366هـ)	أبو عبد الله المصري	n
أبو منصور الثعالبي	عبد الملك بن محمد بن إسماعيل أبو منصور الثعالبي (المتوفى: 429 هـ)	y
أبو الفضل محمد بن طاهر المقدسي المعروف بابن القيسراني	محمد بن طاهر بن علي بن القيسراني	y
أبو الفرج عبد الرحمن بن علي الجوزي	جمال الدين أبي الفرج عبد الرحمن بن الجوزي	y
أبي الفرج عبد الرحمن بن الجوزي	جمال الدين أبي الفرج عبد الرحمن ابن الجوزي	y
أبو الحسن علي بن أحمد بن محمد بن علي الواحدي، النيسابوري، الشافعي (المتوفى : 468هـ)	أبو الحسن علي بن أحمد بن محمد بن علي الواحدي، النيسابوري، الشافعي (المتوفى: 468هـ)	y
أبو البقاء عبد الله بن الحسين بن عبد الله العكبري البغدادي محب الدين (المتوفى: 616هـ)	الشيخ الامام محب الدين أبي البقاء عبد الله بن الحسين العكبري الحنبلي	y
أبو بكر بن المقرئ (المتوفى: 381هـ)	أبو بكر محمد بن إبراهيم بن علي بن عاصم بن زاذان الأصبهاني الخازن، المشهور بابن المقرئ (المتوفى : 381هـ)	y
القاضي عياض	القاضي عياض بن موسى اليحصبي	y
أبو الوليد محمد بن أحمد بن رشد القرطبي (المتوفى: 520هـ)	أبو الوليد محمد بن أحمد بن محمد بن أحمد بن رشد القرطبي الشهير بابن رشد الحفيد (المتوفى: 595هـ)	y
أبو إسماعيل حماد بن إسحاق بن إسماعيل بن حماد بن زيد بن درهم الأزدي البغدادي المالكي (المتوفى: 267هـ)	حماد بن إسحاق بن إسماعيل بن زيد البغدادي أبو إسماعيل	y
أبو المعالي عبد الملك بن عبد الله بن يوسف الجويني	عبد الملك بن عبد الله بن يوسف بن محمد الجويني، أبو المعالي، ركن الدين، الملقب بإمام الحرمين (المتوفى: 478هـ)	y
أبو الحسن علي بن محمد بن حبيب الماوردي البصري	الماوردي	y
أبو العباس، شهاب الدين، ابن نعمة النابلسي، أحمد بن عبد الرحمن بن عبد المنعم بن نعمة بن سلطان بن سرور الحنبلي (المتوفى: 697هـ)	عبد الرحمن بن أحمد بن رجب الحنبلي	n
أبو بكر أحمد بن الحسين البيهقي	أحمد بن الحسين بن علي بن موسى الخسروجردي الخراساني، أبو بكر البيهقي (المتوفى : 458هـ)	y
أبو القاسم علي بن الحسن بن هبة الله المعروف بابن عساكر (المتوفى: 571هـ)	ثقة الدين، أبو القاسم علي بن الحسن بن هبة الله المعروف بابن عساكر (المتوفى: 571هـ)	y
أبو إدريس يحيى بن حمزة بن علي بن إبراهيم، الزيدي الحسيني العلوي الطالبي الملقب بالمؤيد بالله (المتوفى: 745هـ)	يحيى بن حمزة بن علي بن إبراهيم، الحسيني العلوي الطالبي الملقب بالمؤيد بالله (المتوفى: 745هـ)	y
أبو المعالي الجويني الملقب بإمام الحرمين (المتوفى: 478هـ)	عبد الملك بن عبد الله بن يوسف بن محمد الجويني، أبو المعالي، ركن الدين، الملقب بإمام الحرمين (المتوفى: 478هـ)	y
أحمد بن عمرو بن أبي عاصم الشيباني أبو بكر	الضحاك	y
أبو الحسن علي بن محمد بن حبيب البصري البغدادي الماوردي	محمد بن حبيب البغدادي	n
أبو العباس الحسن بن سفيان بن عامر بن عبد العزيز بن النعمان بن عطاء الشيباني الخراساني النسوي (المتوفى: 303هـ)	الشيباني	n
أبو بكر بن أبي داود السجستاني عبد الله بن بن سليمان بن الأشعث	عبد الله بن سليمان الأشعث	y
أبو الفضل أحمد بن علي بن محمد بن أحمد بن حجر العسقلاني (المتوفى: 852هـ)	أحمد بن علي بن محمد بن علي بن حجر العسقلاني	y
علي بن عمر الدارقطني	علي بن عمر بن أحمد الدارقطني	y
أبو القاسم محمود بن عمرو بن أحمد، الزمخشري جار الله (المتوفى : 538هـ)	أبو القاسم محمود بن عمرو بن أحمد، الزمخشري جار الله (المتوفى: 538 هـ)	y
أحمد بن حجر العسقلاني	أحمد بن علي بن محمد بن حجر العسقلاني	y
أبو إسحاق إسماعيل بن جعفر بن أبي كثير الأنصاري الزرقي المدني (المتوفى : 180هـ)	إسماعيل بن جعفر بن أبي كثير الأنصاري الزرقي مولاهم، أبو إسحاق المدني - ويكني أيضا: أبا إبراهيم (المتوفى: 180هـ)	y
أبو بكر أحمد بن علي بن ثابت البغدادي الخطيب	أحمد بن علي بن ثابت أبو بكر الخطيب البغدادي	y
أبو بكر بن أبي داود، عبد الله بن سليمان بن الأشعث الأزدي السجستاني (المتوفى: 316هـ)	عبد الله بن سليمان الأشعث	y
أبو العباس شهاب الدين أحمد بن محمد مكي الحسيني الحموي الحنفي	أحمد بن محمد مكي، أبو العباس، شهاب الدين الحسيني الحموي الحنفي (المتوفى: 1098هـ)	y
عبد الملك بن محمد بن إسماعيل أبو منصور الثعالبي	عبد الملك بن محمد بن إسماعيل أبو منصور الثعالبي (المتوفى: 429 هـ)	y
أبو أحمد عبد الله بن عدي بن عبد الله بن محمد ابن مبارك بن القطان الجرجاني (المتوفى: 365هـ)	عبد الله بن عدي	y
أبو الفضل العراقي	أبو الفضل زين الدين عبد الرحيم العراقي (المتوفى: 806هـ)	y
جمال الدين أبي الفرج عبد الرحمن ابن الجوزي	عبد الرحمن بن علي بن محمد أبو الفرج	y
أحمد بن عمرو بن الضحاك أبو بكر الشيباني	الضحاك	y
ابو الفرج عبد الرحمن بن علي بن الجوزي	عبد الرحمن بن علي بن محمد بن الجوزي أبو الفرج	y
أبو القاسم عبد الرحمن بن إسحاق الزجاجي	عبد الرحمن بن إسحاق البغدادي النهاوندي الزجاجي، أبو القاسم (المتوفى: 337هـ)	y
أبو الفرج عبد الرحمن بن علي بن محمد بن علي بن الجوزي	عبد الرحمن بن علي بن محمد الجوزي	y
ابن الجوزي	جمال الدين أبي الفرج عبد الرحمن ابن الجوزي	y
أبو الفرج عبد الرحمن بن الجوزي	أبو الفرج عبد الرحمن بن علي بن محمد القرشي	y
شمس الدين أبو الخير محمد بن عبد الرحمن السخاوي (المتوفى : 902هـ)	شمس الدين أبو الخير محمد بن عبد الرحمن بن محمد السخاوي (المتوفى: 902هـ)	y
أبو الحسن محمد بن عبد الله بن زكريا بن حيويه النيسابوري ثم المصري الشافعي (المتوفى: 366هـ)	أبو عبد الله المصري	n
أبو منصور عبد الملك بن محمد بن إسماعيل الثعالبي	أبو منصور عبد الملك عبد الملك بن محمد بن إسماعيل الثعالبي	y
أبو البقاء عبد الله بن الحسين بن عبد الله العكبري البغدادي محب الدين (المتوفى: 616هـ)	البغدادي	n
أبو إبراهيم إسماعيل بن يحيى المزني	إسماعيل بن يحيى بن إسماعيل، أبو إبراهيم المزني (المتوفى: 264هـ)	y
تمام بن محمد الدمشقي	تمام بن محمد الرازي أبو القاسم	y
جلال الدين أبي الفضل عبد الرحمن السيوطي	جلال الدين عبد الرحمن السيوطي	y
أبو الحسين يحيى بن أبي الخير بن سالم العمراني اليمني الشافعي (المتوفى: 558هـ)	يحيى بن أبي الخير العمراني	y
أبو الحسين محمد بن عبد الله بن الحسين بن عبد الله بن هارون البغدادي الدقاق المعروف بابن أخي ميمي (المتوفى: 390هـ)	البغدادي	n
أبو الفتح محمد بن عبد الكريم الشهرستاني	أبو الفتح محمد بن عبد الكريم بن أبى بكر أحمد الشهرستاني (المتوفى: 548هـ)	y
أبو بكر أحمد بن علي بن ثابت الخطيب	أبو بكر أحمد بن علي بن ثابت بن أحمد بن مهدي الخطيب البغدادي (المتوفى: 463هـ)	y
أحمد بن علي بن ثابت الخطيب البغدادي	أحمد بن علي بن ثابت الخطيب البغدادي أبو بكر	y
أبو الحسن ظهير الدين علي بن زيد بن محمد بن الحسين البيهقي، الشهير بابن فندمه (المتوفى: 565هـ)	زيد بن علي	n
أبو إسماعيل عبد الله بن محمد بن علي الأنصاري الهروي (المتوفى: 481هـ)	عبد الله الأنصاري الهروي	y
أحمد بن علي بن عبد القادر، أبو العباس الحسيني العبيدي، تقي الدين المقريزي (المتوفى: 845هـ)	المقريزي	y
مجاهد بن جبر	مجاهد بن جبر المخزومي التابعي أبو الحجاج	y
أبو بكر بن أبي داود، عبد الله بن سليمان بن الأشعث الأزدي السجستاني (المتوفى: 316هـ)	سليمان بن الأشعث السجستاني أبو داود	m
أبو الحسين محمد بن أحمد بن محمد بن علي الصيرفي، ابن الآبنوسي البغدادي (المتوفى: 457هـ)	محمد بن أحمد بن الحسين	n
الدارقطني	علي بن عمر بن أحمد الدارقطني أبو الحسن	y
أبو الفرج عبد الرحمن بن علي بن الجوزي	جمال الدين أبي الفرج عبد الرحمن ابن الجوزي	y
أبو بكر أحمد بن الحسين البيهقي	أحمد بن الحسين بن علي البيهقي أبو بكر	y
أبو الفضل محمد بن أبي الحسين أحمد بن محمد بن عمار بن محمد بن حازم بن المعلى بن الجارود الجارودي، الهروي، الشهيد (المتوفى: 317هـ)	محمد بن أحمد بن الحسين	n
أبو بكر أحمد بن علي بن ثابت الخطيب البغدادي (المتوفى: 463هـ)	الخطيب البغدادي	y
أبو الفرج عبد الرحمن بن الجوزي الحنبلي	ياسر عبد الرحمن	n
زين الدين أبو الفضل عبد الرحيم بن الحسين العراقي	عبد الرحيم العراقي	y
علي بن إسماعيل أبو الحسن الأشعري	علي بن إسماعيل بن أبي بشر الأشعري أبو الحسن	y
أبو الحسن ظهير الدين علي بن زيد البيهقي، الشهير بابن فندمه (المتوفى: 565هـ)	البيهقي	n
أبو القاسم حمزة بن يوسف بن إبراهيم السهمي القرشي الجرجاني (المتوفى: 427هـ)	حمزة بن يوسف السهمي	y
أبو العباس أحمد بن محمد بدر الدين ابن محمد شمس الدين ابن علي نور الدين ابن حجر الهيتمي	ابن حجر الهيتمي	y
عبد الملك بن محمد بن إسماعيل أبو منصور الثعالبي (المتوفى : 429هـ)	عبد الملك بن محمد بن إسماعيل أبو منصور الثعالبي (المتوفى: 429 هـ)	y
أبو بكر جعفر بن محمد بن الحسن بن المستفاض الفريابي (المتوفى : 301هـ)	جعفر بن محمد بن الحسن الفريابي	y
آية الله العظمى السيد محمد سعيد الطباطبائي الحكيم	السيد محسن الطباطبائي الحكيم	m
أبو الحسن علي بن محمد الماوردي الشافعي	أبو الحسن علي بن محمد بن حبيب الماوردي البصري	y
عبد الرحمن بن علي بن محمد الجوزي	عبد الرحمن بن علي بن محمد بن الجوزي أبو الفرج	y
أبو الفرج عبد الرحمن بن علي بن محمد بن علي بن عبيد الله بن عبد الله بن هادي بن أحمد بن محمد بن جعفر الجوزي	عبد الرحمن بن علي بن محمد أبو الفرج	y
أبو عبد الله محمد بن عبد الله القضاعي	أبو عبد الله محمد بن فتوح بن عبد الله الحميدي (المتوفى : 488هـ)	n
أبو الفرج عبد الرحمن بن علي بن محمد بن علي بن الجوزي	جمال الدين أبي الفرج عبد الرحمن بن الجوزي	y
أبو بكر أحمد بن علي بن ثابت الخطيب	أبو بكر أحمد بن علي بن ثابت الخطيب البغدادي (المتوفى: 463هـ)	y
أبو الفضل محمد بن طاهر المقدسي المعروف بابن القيسراني	محمد بن طاهر المقدسي	y
أحمد بن علي المقريزي	تقي الدين أحمد بن علي المقريزي	y
علي بن عمر أبو الحسن الدارقطني	علي بن عمر الدارقطني	y
أبو العباس، شهاب الدين، أحمد بن يوسف بن عبد الدائم المعروف بالسمين الحلبي (المتوفى: 756هـ)	أحمد بن يوسف بن عبد الدائم المعروف بالسمين الحلبي (المتوفى : 756هـ)	y
أبو القاسم الحسن بن بشر الآمدي (المتوفى : 370هـ)	أبو القاسم الحسن بن بشر الآمدي (المتوفى: 370 هـ)	y
ابو الفرج عبد الرحمن بن علي بن الجوزي	عبد الرحمن بن علي بن محمد الجوزي	y
أبو القاسم هبة الله بن سلامة بن نصر بن علي البغدادي المقري (المتوفى: 410هـ)	البغدادي	n
علي بن عمر أبو الحسن الدارقطني البغدادي	علي بن عمر بن أحمد الدارقطني أبو الحسن	y
أبو أحمد الحسن بن عبد الله بن سعيد بن إسماعيل العسكري (المتوفى: 382هـ)	أبو هلال الحسن بن عبد الله العسكري	n
أحمد بن علي بن محمد بن حجر العسقلاني	أحمد بن علي بن محمد بن علي بن حجر العسقلاني	y
محمد بن طاهر المقدسي أبو الفضل	محمد بن طاهر بن علي المقدسي أبو الفضل	y
أبو إسماعيل حماد بن إسحاق بن إسماعيل بن حماد بن زيد بن درهم الأزدي البغدادي المالكي (المتوفى: 267هـ)	القاضي أبو إسحاق إسماعيل بن إسحاق بن إسماعيل بن حماد بن زيد الأزدي البصري ثم البغدادي المالكي الجهضمي (المتوفى: 282هـ)	n
أحمد بن الحسين بن علي البيهقي أبو بكر	البيهقي	y
أبو الوليد محمد بن أحمد بن رشد القرطبي (المتوفى: 520هـ)	محمد بن أحمد بن أحمد بن رشد القرطبي أبو الوليد	y
أبو القاسم محمود بن عمر الزمخشري	أبو القاسم محمود بن عمر بن محمد بن عمر الخوارزمي الزمخشري	y
أبو بكر أحمد بن علي بن ثابت بن أحمد بن مهدي الخطيب البغدادي (المتوفى: 463هـ)	أحمد بن علي بن ثابت الخطيب البغدادي	y
أبو الحسين محمد بن المظفر بن موسى بن عيسى بن محمد البغدادي	محمد بن المظفر بن موسى بن عيسى، أبو الحسين البزاز البغدادي (المتوفى: 379هـ)	y
أبو العلاء أحمد بن عبد الله بن سليمان بن محمد بن السليمان المعري	أحمد محمد عبد الله	n
أبو القاسم الحسن بن بشر الآمدي (المتوفى : 370هـ)	أبو القاسم الحسن بن بشر الآمدي (المتوفى: 370هـ)	y
أبو العباس، أحمد بن عبد الله بن محمد، محب الدين الطبري (المتوفى: 694هـ)	محب الدين أحمد بن عبد الله الطبري	y
أبو الفرج عبد الرحمن بن الجوزي الحنبلي	عبد الرحمن بن علي بن محمد بن الجوزي أبو الفرج	y
أبو المنذر هشام بن محمد بن السائب الكلبي (المتوفى: 204هـ)	هشام بن محمد بن السائب الكلبي (المتوفى : 204هـ)	y
أبو المعالي عبد الملك بن عبد الله بن يوسف الجويني	عبد الملك بن عبد الله بن يوسف الجويني	y
أحمد بن الحسين بن علي بن موسى الخسروجردي الخراساني، أبو بكر البيهقي (المتوفى: 458هـ)	البيهقي	y
عبد الرحمن بن علي بن الجوزي	عبد الرحمن بن علي بن محمد أبو الفرج	y
أبو بكر بن الحسين بن عمر، القرشي العبشمي الأموي العثماني، زين الدين، وكنيته أبو محمد ويقال اسمه (عبد الله) والمشهور (أبو بكر) المصري الشافعي المراغي (المتوفى: 816هـ)	أبو عبد الله المصري	m
أبو الفرج عبد الرحمن ابن الجوزي	ابو الفرج عبد الرحمن بن علي بن الجوزي	y
عبد الملك بن عبد الله بن يوسف الجويني	عبد الملك بن عبد الله بن يوسف بن محمد الجويني، أبو المعالي، ركن الدين، الملقب بإمام الحرمين (المتوفى: 478هـ)	y
أبو بكر محمد بن الطيب الباقلاني	الباقلاني	y
"نور الدين أبو الحسن على بن سلطان محمد القاري الهروي المعروف ""بملا على القاري"""	علي بن سلطان محمد القاري	y
أبو الفرج عبد الرحمن بن علي بن محمد بن علي بن الجوزي	عبد الرحمن بن الجوزي أبو الفرج	y
أحمد بن محمد بن علي بن حجر الهيتمي	أحمد بن محمد بن علي بن حجر الهيتمي أبو العباس	y
أبي الفضل جلال الدين عبد الرحمن السيوطي	جلال الدين السيوطي	y
محمد بن طاهر المقدسي	محمد بن طاهر المقدسي أبو الفضل	y
أبو إسماعيل عبد الله بن محمد الأنصاري الهروي (المتوفى: 481هـ)	عبد الله بن محمد الهروي	y
أبو الفرج عبد الرحمن بن علي بن محمد بن علي بن عبيد الله بن عبد الله بن هادي بن أحمد بن محمد بن جعفر الجوزي	أبي الفرج عبد الرحمن بن الجوزي	y
أبو الفضل زين الدين عبد الرحيم بن الحسين بن عبد الرحمن بن أبي بكر بن إبراهيم العراقي (المتوفى: 806هـ)	عبد الرحيم بن الحسين العراقي أبو الفضل	y
أبو الحسن الدارقطني	أبو الحسن علي بن عمر بن أحمد بن مهدي بن مسعود بن النعمان بن دينار البغدادي الدارقطني (المتوفى: 385هـ)	y
أبو الفتح محمد بن الحسين بن أحمد بن عبد الله بن بريدة الموصلي الأزدي (المتوفى: 374هـ)	عبد الله الموصلي	m
أحمد بن حجر العسقلاني	أحمد بن علي العسقلاني أبو الفضل	y
الليث بن سعد	الليث بن سعد بن عبد الرحمن الفهمي المصري	y
أبو الفرج عبد الرحمن بن علي بن محمد بن علي بن عبيد الله بن عبد الله بن هادي بن أحمد بن محمد بن جعفر الجوزي	أحمد علي عبد الله	n
أبو بكر أحمد بن علي بن ثابت البغدادي الخطيب	أبو بكر أحمد بن علي بن ثابت بن أحمد بن مهدي الخطيب البغدادي (المتوفى: 463هـ)	y
أبو العباس الحسن بن سفيان بن عامر بن عبد العزيز بن النعمان بن عطاء الشيباني الخراساني الفسوي (المتوفى : 303هـ)	الحسن بن سفيان النسوي	y
أبو بكر أحمد بن علي بن ثابت الخطيب البغدادي (المتوفى: 463هـ)	أحمد بن علي أبو بكر الخطيب البغدادي	y
أبو إسماعيل عبد الله بن محمد بن علي الأنصاري الهروي (المتوفى: 481هـ)	عبد الله بن محمد بن علي بن محمد الهروي أبو إسماعيل	y
الحافظ أبو الفضل جلال الدين عبد الرحمن ابن أبي بكر السيوطي	جلال الدين عبد الرحمن السيوطي	y
أبو الفضل زين الدين عبد الرحيم العراقي (المتوفى: 806هـ)	أبي الفضل زين الدين عبد الرحيم بن الحسين العراقي	y
أبو الخير محمد بن عبد الرحمن بن محمد السخاوي	شمس الدين أبو الخير محمد بن عبد الرحمن بن محمد السخاوي (المتوفى: 902هـ)	y
أبو بشر محمد بن أحمد بن حماد بن سعيد بن مسلم الأنصاري الدولابي الرازي (المتوفى: 310هـ)	الرازي	n
أبو القاسم إسماعيل بن أحمد بن عمر بن أبي الأشعث السمرقندي، الدمشقي المولد، البغدادي الوطن (المتوفى: 536هـ)	البغدادي	n
أبي الفرج عبد الرحمن بن الجوزي	عبد الرحمن بن الجوزي أبو الفرج	y
أبو أحمد بن عدي الجرجاني (المتوفى: 365هـ)	أبو أحمد عبد الله بن عدي بن عبد الله بن محمد ابن مبارك بن القطان الجرجاني (المتوفى: 365هـ)	y
أبو الفرج عبد الرحمن بن الجوزي الحنبلي	أبو الفرج عبد الرحمن بن علي بن محمد القرشي	y
أبو العباس أحمد بن سلطان بن سرور	أبو العباس، شهاب الدين، ابن نعمة النابلسي، أحمد بن عبد الرحمن بن عبد المنعم بن نعمة بن سلطان بن سرور الحنبلي (المتوفى: 697هـ)	y
الأنصاري الهروي	عبد الله بن محمد بن علي بن محمد الهروي أبو إسماعيل	y
أبو منصور عبد الملك عبد الملك بن محمد بن إسماعيل الثعالبي	عبد الملك بن محمد بن إسماعيل أبو منصور الثعالبي (المتوفى : 429هـ)	y
أبو الحسن الدارقطني	علي بن عمر بن أحمد بن مهدي أبو الحسن الدارقطني البغدادي	y
أبو الفضل زين الدين عبد الرحيم العراقي (المتوفى: 806هـ)	زين الدين أبو الفضل عبد الرحيم بن الحسين العراقي	y
أبو المجد اسعد بن إبراهيم الشيباني الإربلي المعروف بمجد الدين النشابي الكاتب (المتوفى: 657هـ)	الشيباني	n
أبو الحسن خيثمة بن سليمان بن حيدرة بن سليمان القرشي الشامي الأطرابلسي (المتوفى: 343هـ)	خيثمة بن سليمان الأطرابلسي	y
أبو بكر أحمد بن علي بن ثابت البغدادي الخطيب	أحمد بن علي بن ثابت البغدادي	y
أبو القاسم حمزة بن يوسف بن إبراهيم السهمي القرشي الجرجاني (المتوفى: 427هـ)	حمزة بن يوسف أبو القاسم الجرجاني	m
أبو الفرج عبد الرحمن ابن الجوزي	أبو الفرج عبد الرحمن بن أبي الحسن الجوزي	y
جمال الدين أبو الفرج عبد الرحمن بن علي بن محمد الجوزي (المتوفى: 597هـ)	عبد الرحمن بن علي بن محمد بن الجوزي أبو الفرج	y
أبو الفرج عبد الرحمن بن علي بن محمد بن علي بن الجوزي	جمال الدين أبي الفرج عبد الرحمن ابن الجوزي	y
أبو الفرج عبد الرحمن بن علي بن محمد بن علي بن الجوزي	عبد الرحمن بن علي بن محمد أبو الفرج	y
أبو بكر أحمد بن محمد ابن الحافظ الكبير أبي بكر أحمد بن موسى بن مردويه بن فورك بن موسى الأصبهاني (المتوفى: 498هـ)	محمد محمد أبو موسى	n
أبو بكر بن أبي داود السجستاني عبد الله بن بن سليمان بن الأشعث	سليمان بن الأشعث أبو داود	m
أبو عبد الله محمد بن داود بن الجراح (المتوفى : 296هـ)	أبو عبد الله محمد بن فتوح بن عبد الله الحميدي (المتوفى : 488هـ)	n
عبد الله بن سليمان الأشعث	عبد الله بن سليمان الأشعث أبو بكر	y
أحمد بن علي العسقلاني أبو الفضل	أحمد بن علي بن محمد بن حجر العسقلاني	y
أبو الفضل جلال الدين عبد الرحمن أبي بكر السيوطي	أبي الفضل جلال الدين عبد الرحمن السيوطي	y
أبو أحمد عبد الله بن عدي بن عبد الله بن محمد ابن مبارك بن القطان الجرجاني (المتوفى: 365هـ)	أحمد محمد عبد الله	n
أبي منصور عبد الملك بن محمد بن إسماعيل الثعالبي	عبد الملك بن محمد بن إسماعيل أبو منصور الثعالبي	y
أبو الحسن علي بن خلف بن عبد الملك بن بطال البكري القرطبي	القرطبي	n
إبراهيم بن علي بن يوسف الفيروزآبادي الشيرازي أبو إسحاق	إبراهيم بن علي بن يوسف الفيروزأبادي الشيرازي أبو إسحاق	y
أبو الفرج عبد الرحمن بن علي بن محمد القرشي	جمال الدين أبي الفرج عبد الرحمن ابن الجوزي	y
أبو القاسم محمود بن عمر الزمخشري	الزمخشري	y
أبو البركات محمد بن محمد بن محمد الغزي (المتوفى : 984هـ)	محمد بن محمد بن محمد الغزي العامري الدمشقي، أبو البركات، بدر الدين ابن رضي الدين (المتوفى: 984هـ)	y
أبو الحسن علي بن أبي الكرم محمد بن محمد بن عبد الكريم الشيباني	أبو الحسن علي بن أبي الكرم محمد بن محمد بن عبد الكريم بن عبد الواحد الشيباني الجزري، عز الدين ابن الأثير (المتوفى: 630هـ)	y
أبو بكر عبد الله بن محمد بن عبيد ابن أبي الدنيا القرشي البغدادي	أبو بكر عبد الله بن محمد بن عبيد بن أبي الدنيا (المتوفى : 281هـ)	y
أ. د. عبد الرب نواب الدين آل نواب	أ. د.: عبد الرب بن نواب الدين بن غريب الدين آل نواب	y
أبو الفرج عبد الرحمن بن علي بن محمد القرشي	ابو الفرج عبد الرحمن بن علي بن الجوزي	y
أبو الحسن ظهير الدين علي بن زيد البيهقي ، الشهير بابن فندمه (المتوفى : 565هـ)	زيد بن علي	n
أبو الفرج عبد الرحمن بن الجوزي الحنبلي	أبو الفرج عبد الرحمن بن علي بن محمد بن علي بن عبيد الله بن عبد الله بن هادي بن أحمد بن محمد بن جعفر الجوزي	y
أبو إسحاق إبراهيم بن علي الشيرازي	إبراهيم بن علي بن يوسف الفيروزأبادي الشيرازي أبو إسحاق	y
أبو العباس شهاب الدين أحمد بن أبي بكر بن إسماعيل بن سليم بن قايماز بن عثمان البوصيري الكناني الشافعي (المتوفى: 840هـ)	البوصيري	m
الحسن بن عبد الله بن سعيد العسكري أبو أحمد	العسكري	y
الآمدي	علي بن محمد الآمدي أبو الحسن	y
أبو بكر أحمد بن الحسين بن علي بن موسى البيهقي	أحمد بن الحسين بن علي بن موسى الخسروجردي الخراساني، أبو بكر البيهقي (المتوفى : 458هـ)	y
أبو بكر أحمد بن محمد ابن الحافظ الكبير أبي بكر أحمد بن موسى بن مردويه بن فورك بن موسى الأصبهاني (المتوفى: 498هـ)	الحافظ الأصبهاني	n
سليمان بن أحمد بن أيوب الطبراني أبو القاسم	سليمان بن أحمد بن أيوب بن مطير اللخمي الشامي، أبو القاسم الطبراني (المتوفى: 360هـ)	y
أبو القاسم الحسين بن محمد	عبيد الله بن علي بن محمد بن محمد بن الحسين ابن الفراء، أبو القاسم بن أبي الفرج بن أبي خازم ابن القاضي أبي يعلى البغدادي، الحنبلي (المتوفى: 580هـ)	n
أبو بكر بن أبي شيبة	أبو بكر عبد الله بن محمد بن أبي شيبة الكوفي	y
أبو المعالي برهان الدين محمود بن أحمد بن عبد العزيز بن عمر بن مازة البخاري الحنفي (المتوفى: 616هـ)	البخاري	n
ابن حجر الهيتمي	الهيتمي	y
أبو عبد الله محمد بن فتوح بن عبد الله الحميدي (المتوفى : 488هـ)	محمد بن عبد الله باجمعان	n
أحمد بن عبد الله العمري	شمس الدين محمد بن عبد الله بن أحمد، الخطيب العمري التمرتاشي الغزي الحنفي (المتوفى: 1004 هـ)	m
أبو الخير محمد بن أحمد بن محمد بن عمر بن القاسم بن عبد الله بن علي بن إسحاق بن سندار الأصبهاني، المقدر، المهندس، المؤذن، الصوفي، شهر بالباغبان. (المتوفى: 559هـ)	محمد بن أحمد بن إسحاق	n
أبو بكر عبد الله بن سليمان بن الأشعث السجستاني	عبد الله بن سليمان الأشعث أبو بكر	y
أبو البقاء العكبري	أبو البقاء عبد الله بن الحسين بن عبد الله العكبري (المتوفى: 616هـ)	y
أبو المظفر مؤيد الدولة مجد الدين أسامة بن مرشد بن علي بن مقلد بن نصر بن منقذ الكناني الكلبي الشيزري (المتوفى: 584هـ)	أسامة بن منقذ	m
الصفدي	صلاح الدين خليل بن أيبك الصفدي	y
أبو الفضل زين الدين عبد الرحيم العراقي (المتوفى: 806هـ)	عبد الرحيم العراقي	y
أبو الفداء إسماعيل بن عمر بن كثير القرشي البصري ثم الدمشقي (المتوفى: 774هـ)	أبو الفداء إسماعيل بن عمر بن كثير القرشي الدمشقي (المتوفى : 774هـ)	y
علي بن عمر أبو الحسن الدارقطني	علي بن عمر بن أحمد بن مهدي أبو الحسن الدارقطني البغدادي	y
أبو بكر بن علي بن محمد الحدادي العبادي الزبيدي اليمني الحنفي (المتوفى: 800هـ)	الزبيدي	n
أحمد بن علي بن ثابت البغدادي	الخطيب البغدادي	y
أ. د. محمد السيد الجليند	محمد السيد الجليند	y
أبو العباس، شهاب الدين، أحمد بن يوسف بن عبد الدائم المعروف بالسمين الحلبي (المتوفى: 756هـ)	الحلبي	n
علي بن إسماعيل بن سيده (المتوفى : 458هـ)	علي بن إسماعيل بن سيده (المتوفى: 458هـ)	y
أبو الحسن على بن الحسين بن على المسعودي (المتوفى : 346هـ)	أبو الحسن على بن الحسين بن على المسعودي (المتوفى: 346هـ)	y
أبو القاسم سليمان بن أحمد الطبراني	سليمان بن أحمد الطبراني أبو القاسم	y
أحمد بن الحسين البيهقي	البيهقي	y
أبو القاسم خلف بن عبد الملك بن بشكوال (المتوفى : 578هـ)	أبو القاسم خلف بن عبد الملك بن مسعود بن بشكوال الخزرجي الأنصاري الأندلسي (المتوفى: 578هـ)	y
أبو بكر أحمد بن يوسف بن خلاد بن منصور النصيبي ثم البغدادي العطار (المتوفى: 359هـ)	البغدادي	n
أبو عبد الله محمد بن فتوح بن عبد الله الحميدي (المتوفى : 488هـ)	عبد الله بن محمد بن عبد الله بن المبارك	n
أحمد بن الحسين البيهقي أبو بكر	أحمد بن الحسين بن علي بن موسى الخسروجردي الخراساني، أبو بكر البيهقي (المتوفى: 458هـ)	y
أبو العباس الحسن بن سفيان بن عامر بن عبد العزيز بن النعمان بن عطاء الشيباني الخراساني الفسوي (المتوفى : 303هـ)	الشيباني	n
أبو الحجاج مجاهد بن جبر التابعي المكي القرشي المخزومي (المتوفى: 104هـ)	مجاهد بن جبر المخزومي التابعي أبو الحجاج	y
السبكي	علي بن عبد الكافي السبكي	y
أبو العباس، عبد الله بن محمد المعتز بالله ابن المتوكل ابن المعتصم ابن الرشيد العباسي (المتوفى: 296هـ)	عبد الله بن محمد ابن المعتز العباسي (المتوفى : 296هـ)	y
أبو بكر أحمد بن علي بن ثابت الخطيب البغدادي	أبو بكر أحمد بن علي بن ثابت الخطيب البغدادي (المتوفى: 463هـ)	y
الثعالبي	عبد الملك بن محمد بن إسماعيل أبو منصور الثعالبي (المتوفى : 429هـ)	y
أبو الفرج عبد الرحمن بن علي بن محمد بن علي بن الجوزي	ابو الفرج عبد الرحمن بن علي بن الجوزي	y
أبو الفتح، سليم بن أيوب بن سليم الرازي (المتوفى: 447هـ)	الرازي	n
جمال الدين أبي الفرج عبد الرحمن ابن الجوزي	عبد الرحمن بن علي بن محمد الجوزي	y
أبو القاسم عبد الرحمن بن عبد الله بن محمد الغافقي، الجوهري المالكي (المتوفى: 381هـ)	الجوهري	n
أبو الحسن علي بن عمر بن أحمد بن مهدي بن مسعود بن النعمان بن دينار البغدادي الدارقطني (المتوفى : 385هـ)	علي بن عمر أبو الحسن الدارقطني	y
أبو بكر الباقلاني محمد بن الطيب (المتوفى: 403هـ)	محمد بن الطيب الباقلاني	y
أبي الفضل جلال الدين عبد الرحمن السيوطي	جلال الدين عبد الرحمن السيوطي	y
محمد بن الحسين أبو الفتح الأزدي الموصلي	محمد بن الحسين الأزدي أبو الفتح	y
أبو القاسم علي بن الحسن بن هبة الله المعروف بابن عساكر (المتوفى : 571هـ)	ثقة الدين، أبو القاسم علي بن الحسن بن هبة الله المعروف بابن عساكر (المتوفى: 571هـ) من تخريجه لشيخة الفراوي	y
أبو بكر أحمد بن محمد بن هارون بن يزيد الخلال	أبو بكر أحمد بن محمد بن هارون بن يزيد الخلال البغدادي الحنبلي (المتوفى : 311هـ)	y
أبو الفرج عبد الرحمن بن أبي الحسن الجوزي	أبو الفرج عبد الرحمن بن علي بن محمد بن علي بن عبيد الله بن عبد الله بن هادي بن أحمد بن محمد بن جعفر الجوزي	y
أبو بكر أحمد بن علي بن ثابت الخطيب	أحمد بن علي بن ثابت البغدادي أبو بكر	y
أبو الحسن علي بن إسماعيل بن سيده المرسي	أبو الحسن علي بن إسماعيل بن سيده المرسي [ت: 458هـ]	y
عبد الله بن محمد البغوي	عبد الله بن محمد بن عبد العزيز البغوي أبو القاسم	y
أحمد بن عاصم	أحمد بن عمرو بن أبي عاصم الضحاك أبو بكر	n
أبو الحسن علي بن عمر بن محمد ابن الحسن بن شاذان الحميري البغدادي الحربي (المتوفى : 386هـ)	علي بن محمد الحميري	n
أبو الفرج عبد الرحمن بن علي بن محمد القرشي	عبد الرحمن بن علي بن الجوزي	y
أبو العباس أحمد بن يحيى ثعلب	أبو العباس أحمد بن يحيى ثعلب (المتوفى : 291هـ)	y
أبو أحمد حميد بن مخلد بن قتيبة بن عبد الله الخرساني المعروف بابن زنجويه (المتوفى : 251هـ)	أحمد بن عبد الله العمري	n
عبد الرزاق الصنعاني	عبد الرزاق بن همام الصنعاني	y
عبد الرحمن بن علي بن محمد أبو الفرج	عبد الرحمن بن علي بن محمد الجوزي	y
أبو الحسن عبيد الله بن محمد عبد السلام بن خان محمد بن أمان الله بن حسام الدين الرحماني المباركفوري (المتوفى: 1414هـ)	المباركفوري	n
جمال الدين أبو الفرج عبد الرحمن بن علي بن محمد الجوزي (المتوفى: 597هـ)	عبد الرحمن بن علي بن الجوزي	y
أحمد بن علي العسقلاني أبو الفضل	أحمد بن علي بن محمد بن علي بن حجر العسقلاني	y
سليمان بن أحمد بن أيوب أبو القاسم الطبراني	سليمان بن أحمد بن أيوب بن مطير اللخمي الشامي، أبو القاسم الطبراني (المتوفى: 360هـ)	y
أبو بكر بن أبي داود، عبد الله بن سليمان بن الأشعث الأزدي السجستاني (المتوفى: 316هـ)	عبد الله بن سليمان السجستاني	y
أبو القاسم محمود بن عمر الزمخشري الخوارزمي	جار الله الزمخشري	y
أبو الفضل محمد بن طاهر بن علي بن أحمد المقدسي الشيباني، المعروف بابن القيسراني (المتوفى: 507هـ)	الشيباني	n
أحمد بن الحسين البيهقي أبو بكر	أحمد بن الحسين بن علي بن موسى أبو بكر البيهقي	y
أبو بكر أحمد بن إبراهيم الإسماعيلي	أبو بكر أحمد بن إبراهيم بن إسماعيل بن العباس بن مرداس الإسماعيلي الجرجاني (المتوفى: 371هـ)	y
أبو بكر الباقلاني محمد بن الطيب (المتوفى: 403هـ)	أبو بكر محمد بن الطيب الباقلاني	y
شهاب الدين عبد الرحمن بن إسماعيل بن إبراهيم المقدسي الدمشقي	عبد الرحمن بن إسماعيل بن إبراهيم	y
أبو المواهب عبد الوهاب بن أحمد بن علي المعروف بالشعراني	عبد الوهاب	n
أبو بكر محمد بن الحسين بن عبد الله الآجري البغدادي (المتوفى : 360هـ)	أبو بكر محمد بن الحسين بن عبد الله الآجري البغدادي (المتوفى: 360هـ)	y
أبو الحسن علي بن حبيب الماوردي	أبو الحسن علي بن محمد الماوردي	y
أبو بكر بن أبي شيبة، عبد الله بن محمد بن إبراهيم بن عثمان بن خواستي العبسي (المتوفى: 235هـ)	أبي بكر عبد الله بن محمد بن أبي شيبة	y
أحمد بن حجر العسقلاني	أحمد بن علي بن حجر أبو الفضل العسقلاني	y
علي بن أبي بكر الهيثمي	علي بن أبي بكر الهيثمي أبو الحسن	y
ابن الجوزي	جمال الدين أبو الفرج عبد الرحمن بن علي بن محمد الجوزي (المتوفى: 597هـ) (منسوب خطأ في المطبوع لابن قيم الجوزية)	y
الطبراني	سليمان بن أحمد الطبراني أبو القاسم	y
أبو الفرج عبد الرحمن بن الجوزي	أبي الفرج عبد الرحمن بن الجوزي	y
الشيخ محمد حسين الحائري	الشيخ محمد حسين الحاج	n
أبو الحسن علي بن أبي الكرم محمد بن محمد الشيباني الجزري	محمد بن الحسن الشيباني	n
أبو العباس شهاب الدين أحمد بن إدريس بن عبد الرحمن المالكي الشهير بالقرافي (المتوفى: 684هـ)	أحمد بن إدريس المالكي الشهير بالقرافي	y
أبو الحسن تقي الدين علي بن عبد الكافي السبكي (المتوفى: 756هـ)	علي بن عبد الكافي السبكي	y
إبراهيم بن علي بن يوسف الشيرازي أبو إسحاق	إبراهيم بن علي بن يوسف الفيروزأبادي الشيرازي أبو إسحاق	y
عبد الملك الجويني	عبد الملك بن عبد الله بن يوسف الجويني أبو المعالي	y
أبو الفرج عبد الرحمن ابن الجوزي	جمال الدين أبي الفرج عبد الرحمن ابن الجوزي	y
أبو بكر بن أبي عاصم وهو أحمد بن عمرو بن الضحاك بن مخلد الشيباني (المتوفى: 287هـ)	أحمد بن عمرو بن الضحاك أبو بكر الشيباني	y
أبو الفرج عبد الرحمن بن علي بن الجوزي	أبو الفرج عبد الرحمن بن علي بن محمد القرشي	y
شهاب الدين عبد الرحمن بن إسماعيل بن إبراهيم المقدسي الدمشقي	عبد الرحمن بن إسماعيل بن إبراهيم المقدسي أبو شامة	y
أبو الحسن علي بن محمد بن محمد بن حبيب البصري البغدادي، الشهير بالماوردي (المتوفى: 450هـ)	محمد بن حبيب البغدادي	n
أبو الفضائل محمد بن علي بن نظيف الحموي	الحموي	n
أبو الفداء عماد الدين إسماعيل بن علي (المتوفى : 732هـ)	أبو الفداء عماد الدين إسماعيل بن علي بن محمود بن محمد ابن عمر بن شاهنشاه بن أيوب، الملك المؤيد، صاحب حماة (المتوفى: 732هـ)	y
أبو بكر عبد الله بن أبي الدنيا	أبو بكر عبد الله بن محمد بن عبيد بن أبي الدنيا (المتوفى : 281هـ)	y
أبو القاسم شهاب الدين عبد الرحمن بن إسماعيل بن إبراهيم المقدسي الدمشقي المعروف بأبي شامة (المتوفى: 665هـ)	عبد الرحمن بن إسماعيل بن إبراهيم	y
أبو بكر أحمد بن علي بن ثابت الخطيب	أحمد بن علي بن ثابت الخطيب البغدادي أبو بكر	y
أبو الفرج عبد الرحمن ابن الجوزي	أبو الفرج عبد الرحمن بن الجوزي	y
أبي الفرج عبد الرحمن بن الجوزي	عبد الرحمن بن علي بن محمد بن الجوزي أبو الفرج	y
ابن الجوزي	جمال الدين أبو الفرج عبد الرحمن بن علي بن محمد الجوزي (المتوفى: 597هـ)	y
آل تيمية [بدأ بتصنيفها الجد: مجد الدين عبد السلام بن تيمية (ت: 652هـ)، وأضاف إليها الأب،: عبد الحليم بن تيمية (ت: 682هـ)، ثم أكملها الابن الحفيد: أحمد بن تيمية (728هـ)]	أحمد عبد الحليم بن عبد السلام ابن تيمية	n
أبو بكر أحمد بن علي بن ثابت الخطيب البغدادي (المتوفى: 463هـ)	البغدادي	n
أبو الحسن علي بن محمد بن محمد بن حبيب البصري البغدادي، الشهير بالماوردي (المتوفى : 450هـ)	محمد بن حبيب البغدادي	n
أبو الحسن علي بن عمر بن أحمد بن مهدي بن مسعود بن النعمان بن دينار البغدادي الدارقطني (المتوفى : 385هـ)	علي بن عمر الدارقطني	y
أبو الحسن، علاء الدين، علي بن خليل الطرابلسي الحنفي (المتوفى: 844هـ)	علي بن خليل الطرابلسي، أبو الحسن، علاء الدين (المتوفى : 844هـ)	y
أبو بكر عبد الله بن سليمان بن الأشعث السجستاني	عبد الله بن سليمان الأشعث	y
أبو البقاء العكبري	أبو البقاء عبد الله بن الحسين بن عبد الله العكبري البغدادي محب الدين (المتوفى: 616هـ)	y
أحمد بن علي بن ثابت البغدادي	أحمد بن علي بن ثابت الخطيب البغدادي	y
أبو الفضل أحمد بن أبي طاهر ابن طيفور (المتوفى: 280هـ)	ابن طيفور	m
أبو منصور عبد الملك عبد الملك بن محمد بن إسماعيل الثعالبي	أبي منصور عبد الملك بن محمد بن إسماعيل الثعالبي	y
أحمد بن عمرو بن أبي عاصم الشيباني	عمرو بن أبي عاصم الضحاك الشيباني	y
أبو بكر محمد بن إبراهيم بن علي بن عاصم بن زاذان الأصبهاني الخازن، المشهور بابن المقرئ (المتوفى : 381هـ)	أبو بكر محمد بن إبراهيم بن علي بن عاصم بن زاذان الأصبهاني الخازن، المشهور بابن المقرئ (المتوفى: 381هـ)	y
آل تيمية [بدأ بتصنيفها الجد: مجد الدين عبد السلام بن تيمية (ت: 652هـ)، وأضاف إليها الأب،: عبد الحليم بن تيمية (ت: 682هـ)، ثم أكملها الابن الحفيد: أحمد بن تيمية (728هـ)]	تقي الدين أحمد بن عبد السلام بن عبد الحليم بن عبد السلام بن تيمية	n
أبو المعالي عبد الملك بن عبد الله بن يوسف الجويني	عبد الملك بن عبد الله بن يوسف الجويني أبو المعالي	y
أحمد بن علي بن حجر العسقلاني أبو الفضل	أحمد بن علي بن محمد بن حجر العسقلاني	y
أبو الحجاج مجاهد بن جبر التابعي المكي القرشي المخزومي (المتوفى: 104هـ)	مجاهد بن جبر	y
أحمد بن حجر العسقلاني	أحمد بن علي بن محمد بن علي بن حجر العسقلاني	y
أبو القاسم عبد الكريم بن هوازن القشيري	أبو القاسم عبد الكريم بن هوازن بن عبد الملك القشيري النيسابوري الشافعي	y
أبو الفضل محمد بن طاهر المقدسي المعروف بابن القيسراني	محمد بن طاهر بن علي المقدسي أبو الفضل	y
أحمد بن عبد الله العمري	محمد بن أحمد بن محمد عليش، أبو عبد الله المالكي (المتوفى: 1299هـ)	n
أبو الحسن تقي الدين علي بن عبد الكافي السبكي (المتوفى: 756هـ)	السبكي	y
أبو الحسن علي بن عمر بن أحمد بن مهدي بن مسعود بن النعمان بن دينار البغدادي الدارقطني (المتوفى: 385هـ)	علي بن عمر بن أحمد الدارقطني أبو الحسن	y
أبو القاسم شهاب الدين عبد الرحمن بن إسماعيل بن إبراهيم المقدسي الدمشقي المعروف بأبي شامة (المتوفى: 665هـ)	شهاب الدين عبد الرحمن بن إسماعيل بن إبراهيم المقدسي الدمشقي	y
أبو بكر أحمد بن الحسين بن علي بن موسى البيهقي	البيهقي	y
أبو بكر أحمد بن علي بن ثابت الخطيب	الخطيب البغدادي	y
أبو الحسن بن عبد الرحمن بن خلاد الرامهرمزي	الحسن بن عبد الرحمن الرامهرمزي	y
علي بن أبي علي بن محمد بن سالم الآمدي	علي بن محمد الآمدي أبو الحسن	y
عبد الرحمن بن الجوزي أبو الفرج	عبد الرحمن بن علي بن محمد بن الجوزي أبو الفرج	y
أبو الفداء زين الدين قاسم بن قطلوبغا السودوني (نسبة إلى معتق أبيه سودون الشيخوني) الجمالي الحنفي (المتوفى: 879هـ)	زين الدين أبو العدل قاسم بن قطلوبغا السودوني (نسبة إلى معتق أبيه سودون الشيخوني) الجمالي الحنفي (المتوفى: 879هـ)	y
أبو الفرج عبد الرحمن بن الجوزي الحنبلي	عبد الرحمن بن نجم بن عبد الوهاب الجزري السعدي العبادي، أبو الفرج، ناصح الدين ابن الحنبلي (المتوفى: 634هـ)	n
أبو القاسم سليمان بن أحمد الطبراني	سليمان بن أحمد بن أيوب بن مطير اللخمي الشامي، أبو القاسم الطبراني (المتوفى: 360هـ)	y
أبو الفرج عبد الرحمن بن الجوزي الحنبلي	جمال الدين أبو الفرج عبد الرحمن بن علي بن محمد الجوزي (المتوفى: 597هـ) (منسوب خطأ في المطبوع لابن قيم الجوزية)	y
أبو اسحاق إبراهيم بن علي بن يوسف الشيرازي (المتوفى: 476هـ)	إبراهيم بن علي بن يوسف الشيرازي أبو إسحاق	y
أبو القاسم عبد الله بن محمد بن عبد العزيز البغوي	أبو القاسم عبد الله بن محمد بن عبد العزيز بن المرزبان بن سابور بن شاهنشاه البغوي (المتوفى: 317هـ)	y
أبو الحسن ظهير الدين علي بن زيد البيهقي ، الشهير بابن فندمه (المتوفى : 565هـ)	أبو الحسن ظهير الدين علي بن زيد البيهقي، الشهير بابن فندمه (المتوفى: 565هـ)	y
أبو بكر الباقلاني محمد بن الطيب (المتوفى: 403هـ)	محمد بن الطيب بن محمد بن جعفر بن القاسم، القاضي أبو بكر الباقلاني المالكي (المتوفى: 403هـ)	y
أبو الحسن علي بن أحمد بن محمد بن علي الواحدي، النيسابوري، الشافعي (المتوفى : 468هـ)	الواحدي النيسابوري	y
أبو العباس أحمد بن أحمد الطبري	أبو العباس، أحمد بن عبد الله بن محمد، محب الدين الطبري (المتوفى: 694هـ)	n
أبو إسحاق إبراهيم بن محمد بن يحيى بن سختويه النيسابوري المزكي (المتوفى: 362هـ)	محمد بن إسحاق بن محمد بن يحيى	n
أبو بكر أحمد بن موسى بن العباس بن مجاهد البغدادي	البغدادي	n
أبو بكر أحمد بن علي بن ثابت الخطيب البغدادي	أبو بكر أحمد بن علي بن ثابت بن أحمد بن مهدي الخطيب البغدادي (المتوفى: 463هـ)	y
أبو إسحاق إبراهيم بن إسحاق بن إبراهيم بن بشير بن عبد الله البغدادي الحربي (المتوفى: 285هـ)	البغدادي	n
أبو الفرج عبد الرحمن بن الجوزي الحنبلي	عبد الرحمن بن علي بن محمد الجوزي	y
الضحاك	عمرو بن أبي عاصم	y
[ينسب لـ] عبد الملك بن محمد بن إسماعيل أبو منصور الثعالبي (المتوفى: 429هـ)	أبو منصور عبد الملك عبد الملك بن محمد بن إسماعيل الثعالبي	y
أبو الحسن على بن الحسين بن على المسعودي (المتوفى: 346هـ)	المسعودي	y
أبو بكر عبد الله ابن الشيخ أبي منصور محمد ابن الشيخ الكبير أبي الحسين أحمد بن محمد بن عبد الله بن النقور البغدادي، البزاز (المتوفى: 565هـ)	أحمد محمد عبد الله	n
أبو القاسم عبد الرحمن بن عبد الله بن أحمد السهيلي (المتوفى: 581هـ)	عبد الرحمن بن عبد الله السهيلي أبو القاسم	y
أبو الصفا صلاح الدين خليل بن عز الدين أيبك بن عبد الله الألبكي الصفدي	الصفدي	y
أبو الحسن نور الدين علي بن أبي بكر بن سليمان الهيثمي (المتوفى: 807هـ)	علي بن أبي بكر الهيثمي	y
عبد الله بن محمد ابن المعتز العباسي (المتوفى : 296هـ)	عبد الله بن محمد ابن المعتز العباسي (المتوفى: 296هـ)	y
أحمد بن الحسين البيهقي	أحمد بن الحسين بن علي البيهقي أبو بكر	y
أبو بكر أحمد بن علي بن ثابت الخطيب البغدادي (المتوفى: 463هـ)	أحمد بن علي بن ثابت البغدادي	y
أبو القاسم علي بن جعفر السعدي	علي بن جعفر بن علي السعدي، أبو القاسم، المعروف بابن القطاع الصقلي (المتوفى: 515هـ)	y
أبو بكر أحمد بن محمد بن هارون بن يزيد الخلال	أبو بكر أحمد بن محمد بن هارون بن يزيد الخلال البغدادي (المتوفى : 311هـ)	y
أبو الحسين أحمد بن فارس بن زكريا (المتوفى : 395هـ)	أحمد بن فارس بن زكريا بن محمد بن حبيب أبو الحسين الرازي	y
أبو الحسن علي بن بسام الشنتريني	أبو الحسن علي بن بسام الشنتريني (المتوفى: 542هـ)	y
أبو المظفر، منصور بن محمد بن عبد الجبار ابن أحمد المروزى السمعاني التميمي الحنفي ثم الشافعي (المتوفى: 489هـ)	السمعاني	y
أبو الحسن الدارقطني	الدارقطني	y
أبو الفرج عبد الرحمن بن الجوزي الحنبلي	أبو الفرج عبد الرحمن بن علي بن محمد بن علي بن الجوزي	y
أبو بكر أحمد بن علي بن ثابت البغدادي الخطيب	أبو بكر أحمد بن علي بن ثابت الخطيب البغدادي (المتوفى: 463هـ)	y
ابو الفرج عبد الرحمن بن علي بن الجوزي	عبد الرحمن بن علي بن الجوزي	y
أبو الوليد سليمان بن خلف بن سعد بن أيوب بن وارث التجيبي القرطبي الباجي الأندلسي (المتوفى: 474هـ)	القرطبي	n
علي بن أبي بكر الهيثمي	نور الدين علي بن أبي بكر بن سليمان الهيثمي (المتوفى: 807هـ)	y
أبو الحسن علي بن أبي الكرم محمد بن محمد بن عبد الكريم بن عبد الواحد الشيباني الجزري، عز الدين ابن الأثير (المتوفى: 630هـ)	ابن الأثير	y
أبو القاسم خلف بن عبد الملك بن بشكوال (المتوفى : 578هـ)	خلف بن عبد الملك بن بشكوال أبو القاسم	y
أبو البشر عمرو بن عثمان بن قنبر سيبويه	عمرو بن عثمان بن قنبر الحارثي بالولاء، أبو بشر، الملقب سيبويه (المتوفى: 180هـ)	y
أبو الفرج عبد الرحمن بن الجوزي	عبد الرحمن بن الجوزي أبو الفرج	y
أحمد بن علي بن ثابت البغدادي أبو بكر	أحمد بن علي بن ثابت الخطيب البغدادي	y
أبو اسحاق إبراهيم بن علي بن يوسف الشيرازي (المتوفى: 476هـ)	إبراهيم بن علي بن يوسف الفيروزآبادي الشيرازي أبو إسحاق	y
أبو البقاء العكبري	أبو البقاء عبد الله بن الحسين بن عبد الله العكبري	y
أبو القاسم محمود بن عمر بن محمد بن عمر الخوارزمي الزمخشري	أبو القاسم محمود بن عمرو بن أحمد، الزمخشري جار الله (المتوفى : 538هـ)	y
أبو أحمد الحسن بن عبد الله بن سعيد بن إسماعيل العسكري (المتوفى: 382هـ)	العسكري	y
أبو البقاء عبد الله بن الحسين بن عبد الله العكبري	الشيخ الامام محب الدين أبي البقاء عبد الله بن الحسين العكبري الحنبلي	y
جمال الدين أبي الفرج عبد الرحمن بن الجوزي	عبد الرحمن بن علي بن محمد أبو الفرج	y
أحمد بن الحسين بن علي البيهقي أبو بكر	أحمد بن الحسين بن علي بن موسى الخسروجردي الخراساني، أبو بكر البيهقي (المتوفى: 458هـ)	y
أبو المنذر هشام بن محمد أبي النضر ابن السائب ابن بشر الكلبي (المتوفى: 204هـ)	أبو المنذر هشام بن محمد بن السائب الكلبي (المتوفى : 204هـ)	y
أبو أحمد الحسن بن عبد الله بن سعيد بن إسماعيل العسكري (المتوفى: 382هـ)	سعيد إسماعيل	n
أبو الفرج عبد الرحمن بن أبي الحسن الجوزي	عبد الرحمن بن علي بن محمد الجوزي	y
الغرناطي الكلبي	محمد بن أحمد بن جزي الكلبي الغرناطي	y
أبو الحسن الدارقطني	علي بن عمر الدارقطني	y
أبو بكر بن أبي داود، عبد الله بن سليمان بن الأشعث الأزدي السجستاني (المتوفى: 316هـ)	سليمان بن الأشعث أبو داود	m
أبو الحسن علي بن أبي الكرم محمد بن محمد بن عبد الكريم بن عبد الواحد الشيباني الجزري، عز الدين ابن الأثير (المتوفى: 630هـ)	عز الدين بن الأثير أبي الحسن علي بن محمد الجزري	y
أبو الفرج عبد الرحمن بن علي بن محمد القرشي	عبد الرحمن بن علي بن محمد الجوزي	y
محب الدين أحمد بن عبد الله الطبري	محب الدين أحمد بن عبد الله الطبري (المتوفى: 694هـ)	y
السبكي	تقي الدين علي بن عبد الكافي السبكي (المتوفى : 756هـ)	y
أبو بكر أحمد بن علي بن ثابت الخطيب البغدادي	أحمد بن علي بن ثابت الخطيب البغدادي أبو بكر	y
أبو إسماعيل عبد الله بن محمد الأنصاري الهروي (المتوفى: 481هـ)	عبد الله بن محمد بن علي بن محمد الهروي أبو إسماعيل	y
آية الله العظمى السيد محمد سعيد الطباطبائي الحكيم	السيد محمد سعيد الحكيم	m
عبد الملك بن محمد بن إسماعيل أبو منصور الثعالبي (المتوفى : 429هـ)	عبد الملك بن محمد بن إسماعيل أبو منصور الثعالبي (المتوفى: 429هـ)	y
أبو بكر النجاد، أحمد بن سلمان بن الحسن بن إسرائيل بن يونس البغدادي (المتوفى: 348هـ)	أحمد بن سلمان النجاد أبو بكر	y
أبو القاسم عبد الرحمن بن إسحاق الزجاجي	عبد الرحمن بن إسحاق البغدادي النهاوندي الزجاجي، أبو القاسم (المتوفى : 337هـ)	y
أبو الفداء زين الدين قاسم بن قطلوبغا السودوني	أبو الفداء زين الدين قاسم بن قطلوبغا السودوني (نسبة إلى معتق أبيه سودون الشيخوني) الجمالي الحنفي (المتوفى: 879هـ)	y
السيوطي	جلال الدين عبد الرحمن السيوطي	y
أبا علي إسماعيل بن القاسم القالي البغدادي	البغدادي	n
أبو بكر عبد الله بن محمد بن عبيد ابن أبي الدنيا القرشي البغدادي	أبو بكر عبد الله بن محمد بن عبيد بن سفيان بن قيس البغدادي الأموي القرشي المعروف بابن أبي الدنيا (المتوفى: 281هـ)	y
أبو الحسن علي بن عمر بن محمد ابن الحسن بن شاذان الحميري البغدادي الحربي (المتوفى : 386هـ)	الحميري	n
أبو القاسم الحسن بن بشر الآمدي (المتوفى : 370هـ)	الآمدي	n
أبو الفرج عبد الرحمن بن الجوزي الحنبلي	جمال الدين أبي الفرج عبد الرحمن ابن الجوزي	y
علي بن عمر الدارقطني	علي بن عمر بن أحمد بن مهدي أبو الحسن الدارقطني البغدادي	y
عبد الملك بن محمد بن إسماعيل أبو منصور الثعالبي (المتوفى: 429 هـ)	عبد الملك بن محمد بن إسماعيل أبو منصور الثعالبي (المتوفى: 429هـ)	y
أبو الفضل جلال الدين عبد الرحمن أبي بكر السيوطي	السيوطي	y
أبو بكر أحمد بن محمد ابن الحافظ الكبير أبي بكر أحمد بن موسى بن مردويه بن فورك بن موسى الأصبهاني (المتوفى: 498هـ)	أبو بكر أحمد بن محمد بن أبي بكر بن مردويه	y
أبو الحسن ظهير الدين علي بن زيد بن محمد بن الحسين البيهقي، الشهير بابن فندمه (المتوفى: 565هـ)	محمد محب الدين أبو زيد	n
علي بن إسماعيل أبو الحسن الأشعري	علي بن إسماعيل الأشعري أبو الحسن	y
أبو الفرج عبد الرحمن بن الجوزي الحنبلي	عبد الرحمن بن محمد بن قاسم العاصمي الحنبلي النجدي (المتوفى: 1392هـ) - عبد العزيز بن عبد الله بن باز (المتوفى: 1420هـ)	n
أبو الحسن ظهير الدين علي بن زيد بن محمد بن الحسين البيهقي، الشهير بابن فندمه (المتوفى: 565هـ)	البيهقي	n
أبو الحسن علي بن عمر بن أحمد الدارقطني	علي بن عمر أبو الحسن الدارقطني البغدادي	y
أبو بكر عبد الله ابن الشيخ أبي منصور محمد ابن الشيخ الكبير أبي الحسين أحمد بن محمد بن عبد الله بن النقور البغدادي، البزاز (المتوفى: 565هـ)	البغدادي	n
أبو الحسن علي بن أحمد بن محمد بن علي الواحدي، النيسابوري، الشافعي (المتوفى : 468هـ)	الواحدي	y
أبو بكر محمد بن الطيب الباقلاني	محمد بن الطيب بن محمد بن جعفر بن القاسم، القاضي أبو بكر الباقلاني المالكي (المتوفى: 403هـ)	y
[ينسب لـ] عبد الملك بن محمد بن إسماعيل أبو منصور الثعالبي (المتوفى: 429هـ)	عبد الملك بن محمد بن إسماعيل أبو منصور الثعالبي	y
أبي إسحاق إبراهيم بن علي الشيرازي	إبراهيم بن علي بن يوسف الشيرازي أبو إسحاق	y
أبو الحسن علي بن أبي الكرم محمد بن محمد بن عبد الكريم الشيباني	ابن الأثير	y
أبو الحسن علي بن عبد العزير القاضي الجرجاني (المتوفى: 392هـ)	الجرجاني	n
أبو الفضل عبد الرحمن بن أحمد بن الحسن بن بندار العجلي الرازي المقرئ	الرازي	n
أبو الفرج عبد الرحمن بن علي الجوزي	أبو الفرج عبد الرحمن بن علي بن محمد بن علي بن الجوزي	y
المقريزي	تقي الدين أبي العباس أحمد بن علي بن عبد القادر العبيدي المقريزي	y
أبو بكر أحمد بن علي بن ثابت بن أحمد بن مهدي الخطيب البغدادي (المتوفى: 463هـ)	أحمد بن علي بن ثابت البغدادي	y
أبي الفضل زين الدين عبد الرحيم بن الحسين العراقي	عبد الرحيم بن الحسين العراقي أبو الفضل	y
سليمان بن أحمد الطبراني أبو القاسم	سليمان بن أحمد بن أيوب بن مطير اللخمي الشامي، أبو القاسم الطبراني (المتوفى : 360هـ)	y
أبو إسحاق إبراهيم بن حرب العسكري، السمسار (المتوفى: بعد 282هـ)	العسكري	m
عبد الرحمن بن إسماعيل أبو شامة	عبد الرحمن بن إسماعيل بن إبراهيم	y
أبو الفرج عبد الرحمن بن علي بن محمد القرشي	ابن الجوزي	y
أبو بكر بن أبي داود السجستاني عبد الله بن بن سليمان بن الأشعث	سليمان بن الأشعث أبو داود السجستاني	m
أبو القاسم البغوي	أبو القاسم عبد الله بن محمد بن عبد العزيز بن المرزبان بن سابور بن شاهنشاه البغوي (المتوفى: 317هـ)	y
أبو الفرج عبد الرحمن بن الجوزي	أبو الفرج عبد الرحمن بن علي بن محمد بن علي بن عبيد الله بن عبد الله بن هادي بن أحمد بن محمد بن جعفر الجوزي	y
أبو الحسن علي بن عمر بن أحمد بن مهدي بن مسعود بن النعمان بن دينار البغدادي الدارقطني (المتوفى: 385هـ)	علي بن عمر بن أحمد بن مهدي أبو الحسن الدارقطني البغدادي	y
أبو العباس أحمد بن محمد بن علي ابن حجر الهيثمي	ابن حجر الهيثمي	y
أحمد بن حجر العسقلاني	أحمد بن علي بن حجر	y
أبو الفرج عبد الرحمن بن علي الجوزي	ابن الجوزي	y
شمس الدين أبو الخير محمد بن عبد الرحمن السخاوي (المتوفى : 902هـ)	شمس الدين أبو الخير محمد بن عبد الرحمن بن محمد بن أبي بكر بن عثمان بن محمد السخاوي (المتوفى: 902هـ)	y
أبو الفضل عبيد الله بن عبد الرحمن بن محمد بن عبيد الله بن سعد بن إبراهيم (المتوفى : 381هـ)	محمد بن سعد	n
أبو الفرج عبد الرحمن بن علي الجوزي	جمال الدين أبو الفرج عبد الرحمن بن علي بن محمد الجوزي (المتوفى: 597هـ)	y
أبو الخير بدل بن أبي المعمر بن إسماعيل التبريزي (المتوفى: 636هـ)	التبريزي	n
أبو الحسن علي بن أبي الكرم محمد بن محمد بن عبد الكريم الشيباني	عز الدين بن الأثير أبي الحسن علي بن محمد الجزري	y
أبو الفضل أحمد بن علي بن محمد بن أحمد بن حجر العسقلاني (المتوفى: 852هـ)	أحمد بن علي بن محمد بن حجر العسقلاني	y
أبو الفضل عبد الرحيم بن الحسين العراقي	زين الدين أبو الفضل عبد الرحيم بن الحسين العراقي	y
أبو السعد زين الدين منصور بن أبي النصر بن محمد الطبلاوي	أبو السعد زين الدين منصور بن أبي النصر بن محمد الطبلاوي، سبط ناصر الدين محمد بن سالم (المتوفى: 1014هـ)	y
أبو الفرج عبد الرحمن بن أبي الحسن الجوزي	عبد الرحمن بن الجوزي أبو الفرج	y
أحمد بن علي بن ثابت البغدادي	أحمد بن علي بن ثابت الخطيب البغدادي أبو بكر	y
أبو الفرج عبد الرحمن بن علي بن محمد بن علي بن عبيد الله بن عبد الله بن هادي بن أحمد بن محمد بن جعفر الجوزي	أحمد محمد عبد الله	n
أبو الحسن علي بن عمر بن أحمد بن مهدي بن مسعود بن النعمان بن دينار البغدادي الدارقطني (المتوفى: 385هـ)	علي بن عمر بن أحمد الدارقطني	y
أبو الحسن علي بن أبي الكرم محمد بن محمد بن عبد الكريم الشيباني	الشيباني	n
أبو الحسن علي بن إسماعيل بن سيده المرسي	علي بن إسماعيل بن سيده (المتوفى: 458هـ)	y
أبو الفرج عبد الرحمن بن الجوزي	عبد الرحمن بن علي بن محمد الجوزي	y
أبو الوليد إسماعيل بن يوسف بن الأحمر (المتوفى : 807هـ)	إسماعيل بن يوسف بن محمد بن نصر الخزرجي الأنصاري النصري، أبو الوليد، المعروف بابن الأحمر (المتوفى: 807هـ)	y
أبو العباس أحمد بن أحمد الطبري	الطبري	n
أبو الحسين محمد بن أحمد بن محمد بن علي الصيرفي، ابن الآبنوسي البغدادي (المتوفى: 457هـ)	البغدادي	n
أبو بكر عبد الله بن محمد بن عبيد ابن أبي الدنيا القرشي البغدادي	أبو بكر عبد الله بن محمد بن عبيد البغدادي (ابن أبي الدنيا)	y
أبو الفرج عبد الرحمن بن الجوزي الحنبلي	عبد الرحمن بن محمد بن أحمد بن قدامة المقدسي الجماعيلي الحنبلي، أبو الفرج، شمس الدين (المتوفى: 682هـ)	n
الزمخشري	جار الله الزمخشري	y
أبو البقاء العكبري	أبو البقاء عبد الله بن الحسين العكبري	y
أبو الحسن علي بن محمد بن حبيب البصري البغدادي الماوردي	الماوردي	y
أبو الطيب محمد صديق خان بن حسن بن علي ابن لطف الله الحسيني البخاري القنوجي (المتوفى: 1307هـ)	صديق بن حسن القنوجي	y
أبو إسماعيل عبد الله بن محمد الأنصاري الهروي (المتوفى: 481هـ)	محمد بن عبد الله الأنصاري	n
أبو الوليد محمد بن أحمد بن محمد بن أحمد بن رشد القرطبي الشهير بابن رشد الحفيد (المتوفى : 595هـ)	محمد بن أحمد بن محمد بن رشد القرطبي أبو الوليد	y
أبو الحسين محمد بن المظفر بن موسى بن عيسى بن محمد البغدادي	محمد محمد أبو موسى	n
علي بن عمر بن أحمد الدارقطني	علي بن عمر بن أحمد بن مهدي أبو الحسن الدارقطني البغدادي	y
أبو البقاء عبد الله بن الحسين بن عبد الله العكبري (المتوفى: 616هـ)	الشيخ الامام محب الدين أبي البقاء عبد الله بن الحسين العكبري الحنبلي	y
عبد الله بن محمد الهروي	عبد الله بن محمد بن علي بن محمد الهروي أبو إسماعيل	y
سليمان بن أحمد الطبراني أبو القاسم	سليمان بن أحمد بن أيوب الطبراني أبو القاسم	y
أبو الحسين محمد بن المظفر (المتوفى: 379هـ)	محمد بن المظفر بن موسى بن عيسى، أبو الحسين البزاز البغدادي (المتوفى: 379هـ)	y
أبو الفرج عبد الرحمن بن علي بن محمد بن علي بن عبيد الله بن عبد الله بن هادي بن أحمد بن محمد بن جعفر الجوزي	جمال الدين أبي الفرج عبد الرحمن بن الجوزي	y
أبو المواهب عبد الوهاب بن أحمد بن علي المعروف بالشعراني	أحمد عبد الوهاب	n
[ينسب لـ] عبد الملك بن محمد بن إسماعيل أبو منصور الثعالبي (المتوفى: 429هـ)	عبد الملك بن محمد بن إسماعيل أبو منصور الثعالبي (المتوفى: 429هـ)	y
أبو الفرج عبد الرحمن ابن الجوزي	أبو الفرج عبد الرحمن بن علي بن الجوزي	y
أبو القاسم علي بن الحسن بن هبة الله المعروف بابن عساكر (المتوفى : 571هـ)	ثقة الدين، أبو القاسم علي بن الحسن بن هبة الله المعروف بابن عساكر (المتوفى: 571هـ)	y
أبو الفرج عبد الرحمن بن علي بن محمد بن علي بن الجوزي	أبو الفرج عبد الرحمن بن علي بن محمد بن علي بن عبيد الله بن عبد الله بن هادي بن أحمد بن محمد بن جعفر الجوزي	y
أبو الفرج عبد الرحمن بن علي بن محمد القرشي	عبد الرحمن بن علي بن محمد أبو الفرج	y
أبو الفضل العراقي	عبد الرحيم بن الحسين العراقي أبو الفضل	y
أبو بكر أحمد بن علي بن ثابت الخطيب	أحمد بن علي بن ثابت الخطيب البغدادي	y
أبو الفضل عبد الرحمن جلال الدين السيوطي	الحافظ أبو الفضل جلال الدين عبد الرحمن ابن أبي بكر السيوطي	y
أبو الفرج عبد الرحمن بن أحمد بن رجب الحنبلي (المتوفى: 795هـ)	عبد الرحمن بن أحمد بن رجب الحنبلي (المتوفى: 795هـ)	y
أبو بكر أحمد بن محمد ابن الحافظ الكبير أبي بكر أحمد بن موسى بن مردويه بن فورك بن موسى الأصبهاني (المتوفى: 498هـ)	الأصبهاني	n
أبو الحارث سريج بن يونس بن إبراهيم البغدادي (المتوفى : 235هـ)	أبو الحارث سريج بن يونس بن إبراهيم البغدادي (المتوفى: 235هـ)	y
أبو بكر أحمد بن الحسين البيهقي	أحمد بن الحسين البيهقي	y
أبو الفضائل أحمد بن محمد بن المظفر بن المختار الرازي	الرازي	n
تقي الدين علي بن عبد الكافي السبكي (المتوفى : 756هـ)	علي بن عبد الكافي السبكي	y
أبو القاسم عبد الله بن محمد بن عبد العزيز البغوي	عبد الله بن محمد بن عبد العزيز بن المرزبان البغوي أبو القاسم	y
أبو العباس، شهاب الدين، ابن نعمة النابلسي، أحمد بن عبد الرحمن بن عبد المنعم بن نعمة بن سلطان بن سرور الحنبلي (المتوفى: 697هـ)	ابن شهاب	n
أبو الفتح محمد بن الحسين بن أحمد بن عبد الله بن بريدة الموصلي الأزدي (المتوفى: 374هـ)	أحمد محمد عبد الله	n
أبو الفرج عبد الرحمن بن أبي الحسن الجوزي	جمال الدين أبي الفرج عبد الرحمن ابن الجوزي	y
أبو الفضل أحمد بن علي بن محمد بن أحمد بن حجر العسقلاني (المتوفى: 852هـ)	أحمد بن حجر العسقلاني	y
أبو المنذر هشام بن محمد بن السائب الكلبي (المتوفى : 204هـ)	هشام بن محمد بن السائب الكلبي (المتوفى : 204هـ)	y
أبو بكر أحمد بن محمد بن هارون بن يزيد الخلال البغدادي (المتوفى : 311هـ)	أبو بكر أحمد بن محمد بن هارون بن يزيد الخلال البغدادي الحنبلي (المتوفى: 311هـ)	y
أبي الفرج عبد الرحمن بن الجوزي	جمال الدين أبي الفرج عبد الرحمن بن الجوزي	y
جعفر بن محمد بن الحسن الفريابي	جعفر بن محمد بن الحسن الفريابي أبو بكر	y
الدارقطني	علي بن عمر أبو الحسن الدارقطني	y
أبو المنجى عبد الله بن عمر بن علي بن زيد، ابن اللتي البغدادي، الحريمي، الطاهري، القزاز (المتوفى: 635هـ)	زيد بن علي	n
أحمد بن علي بن حجر العسقلاني	أحمد بن علي بن محمد بن حجر العسقلاني	y
أبو القاسم هبة الله بن الحسن بن منصور الطبري الرازي اللالكائي (المتوفى: 418هـ)	هبة الله بن الحسن بن منصور اللالكائي أبو القاسم	y
أحمد بن علي بن ثابت أبو بكر الخطيب البغدادي	أحمد بن علي بن ثابت الخطيب البغدادي	y
أبو بكر بن أبي عاصم وهو أحمد بن عمرو بن الضحاك بن مخلد الشيباني (المتوفى: 287هـ)	الشيباني	n
أبو الحسن علي بن إسماعيل بن سيده المرسي	علي بن إسماعيل بن سيده (المتوفى : 458هـ)	y
أبو الحسن تقي الدين علي بن عبد الكافي السبكي (المتوفى: 756هـ)	تاج الدين بن علي بن عبد الكافي السبكي	n
أ. د / عبد الله بن محمد بن أحمد الطيار	أحمد محمد عبد الله	n
أبو الحارث الليث بن سعد بن عبد الرحمن الفهمي المصري (المتوفى: 175هـ)	أبو عبد الرحمن المصري	n
الغرناطي الكلبي	محمد بن أحمد بن محمد الغرناطي الكلبي	y
أحمد بن الحسين البيهقي	أحمد بن الحسين بن علي بن موسى أبو بكر البيهقي	y
أبو القاسم محمود بن عمرو بن أحمد، الزمخشري جار الله (المتوفى : 538هـ)	محمود بن عمر الزمخشري	y
أبو الحسن علي بن أبي الكرم محمد بن محمد الشيباني الجزري	ابن الأثير	y
آل تيمية [بدأ بتصنيفها الجد: مجد الدين عبد السلام بن تيمية (ت: 652هـ)، وأضاف إليها الأب،: عبد الحليم بن تيمية (ت: 682هـ)، ثم أكملها الابن الحفيد: أحمد بن تيمية (728هـ)]	عبد السلام + عبد الحليم + أحمد بن عبد الحليم آل تيمية	n
أبو الحسن علي بن أبي الكرم محمد بن محمد بن عبد الكريم الشيباني	ابن الأثير الجزري	y
محمد بن أحمد بن جزي الكلبي الغرناطي	محمد بن أحمد بن محمد الغرناطي الكلبي	y
أبو بكر أحمد بن مروان بن محمد الدينوري القاضي المالكي	الدينوري	n
أبو بكر بن أبي داود، عبد الله بن سليمان بن الأشعث الأزدي السجستاني (المتوفى: 316هـ)	أبو بكر عبد الله بن سليمان بن الأشعث السجستاني	y
محمد بن يزيد المبرد، أبو العباس (المتوفى : 285هـ)	محمد بن يزيد المبرد، أبو العباس (المتوفى: 285هـ)	y
أبو الحسن علي بن عبد الله بن محمد بن محمد ابن الحسن الجذامي النباهي المالقي الأندلسي (المتوفى: نحو 792هـ)	عبد الله بن محمد الأندلسي أبو محمد	n
أبو الفرج عبد الرحمن بن الجوزي	أبو الفرج عبد الرحمن بن علي بن الجوزي	y
أبو الحسن علي بن أحمد بن محمد بن علي الواحدي، النيسابوري، الشافعي (المتوفى: 468هـ)	الواحدي النيسابوري	y
أبو الفرج عبد الرحمن بن الجوزي الحنبلي	أبو عبد الرحمن المصري	n
عبد الرحمن بن علي بن الجوزي	عبد الرحمن بن علي بن محمد الجوزي	y
أبو المحاسن يوسف بن أحمد بن محمود اليغموري (المتوفى : 673هـ)	أبو المحاسن يوسف بن أحمد بن محمود اليغموري (المتوفى: 673هـ)	y
أبو الفضائل الحسن بن حيدر بن علي القرشي	علي حيدر	n
أبو القاسم الحسين بن محمد المعروف بالراغب الأصفهانى (المتوفى: 502هـ)	أبو القاسم الحسين بن محمد المعروف بالراغب الاصفهانى (المتوفى : 502هـ)	y
أبو الحسن بن عبد الله بن الحسن النباهي المالقي الأندلسي	أبو الحسن علي بن عبد الله بن محمد بن محمد ابن الحسن الجذامي النباهي المالقي الأندلسي (المتوفى: نحو 792هـ)	y
أبو الحسن مقاتل بن سليمان بن بشير الأزدي البلخى (المتوفى: 150هـ)	مقاتل بن سليمان	y
أبو الفتح ضياء الدين نصر الله بن محمد بن محمد بن عبد الكريم المعروف بابن الأثير	نصر الله بن محمد بن محمد بن عبد الكريم الشيباني، الجزري، أبو الفتح، ضياء الدين، المعروف بابن الأثير الكاتب (المتوفى: 637هـ)	y
أبو الطيب محمد صديق خان بن حسن بن علي ابن لطف الله الحسيني البخاري القنوجي (المتوفى: 1307هـ)	محمد صديق حسن خان القنوجي	y
أبو القاسم عبد الله بن محمد بن عبد العزيز بن المرزبان بن سابور بن شاهنشاه البغوي (المتوفى: 317هـ)	البغوي	n
أبو الفضل جلال الدين عبد الرحمن أبي بكر السيوطي	جلال الدين السيوطي	y
جلال الدين أبي الفضل عبد الرحمن السيوطي	جلال الدين السيوطي	y
أبو بكر أحمد بن محمد بن هارون بن يزيد الخلال البغدادي (المتوفى : 311هـ)	أبو بكر أحمد بن محمد بن هارون بن يزيد الخلال البغدادي الحنبلي (المتوفى : 311هـ)	y
أبو إسحاق إبراهيم بن علي الشيرازي	أبو اسحاق إبراهيم بن علي الشيرازي (المتوفى: 476هـ)	y
أبو بشر محمد بن أحمد بن حماد الدولابي	محمد بن أحمد الدولابي	y
أبو الفضل زين الدين عبد الرحيم العراقي (المتوفى: 806هـ)	أبو الفضل عبد الرحيم بن الحسين العراقي	y
عبد الملك الجويني	عبد الملك بن عبد الله بن يوسف الجويني	y
أبو الفرج عبد الرحمن بن علي بن الجوزي	ابن الجوزي	y
أبو الحسن سيد الدين علي بن أبي علي بن محمد بن سالم الثعلبي الآمدي (المتوفى: 631هـ)	الآمدي	y
أبو الفرج عبد الرحمن بن الجوزي	ابن الجوزي	y
أبو بكر أحمد بن الحسين بن علي بن عبد الله البيهقي	أحمد علي عبد الله	n
أبو العباس أحمد بن علي القلقشندي (المتوفى : 821هـ)	أبو العباس أحمد بن علي القلقشندي (المتوفى: 821هـ)	y
أبو بكر أحمد بن الحسين البيهقي	أحمد بن الحسين بن علي بن موسى أبو بكر البيهقي	y
أحمد بن الحسين البيهقي أبو بكر	البيهقي	y
أبو بكر أحمد بن الحسين بن علي بن عبد الله البيهقي	أحمد بن الحسين البيهقي أبو بكر	y
أبو الفضل زين الدين عبد الرحيم بن الحسين بن عبد الرحمن بن أبي بكر بن إبراهيم العراقي (المتوفى: 806هـ)	زين الدين أبو الفضل عبد الرحيم بن الحسين العراقي	y
أبو اسحاق إبراهيم بن علي الشيرازي (المتوفى: 476هـ)	إبراهيم بن علي بن يوسف الفيروزأبادي الشيرازي أبو إسحاق	y
[ينسب لـ] عبد الملك بن محمد بن إسماعيل أبو منصور الثعالبي (المتوفى: 429هـ)	أبي منصور عبد الملك بن محمد بن إسماعيل الثعالبي	y
أبو منصور الثعالبي	الثعالبي	y
أبو الفضل القاضي عياض بن موسى اليحصبي (المتوفى: 544هـ)	القاضي عياض بن موسى اليحصبي	y
أبو بكر أحمد بن علي بن ثابت الخطيب البغدادي (المتوفى: 463هـ)	أحمد بن علي بن ثابت البغدادي أبو بكر	y
أبو الوليد محمد بن عبد الله بن أحمد الأزرقي	أحمد محمد عبد الله	n
أبو أحمد عبد الله بن عدي بن عبد الله بن محمد ابن مبارك بن القطان الجرجاني (المتوفى: 365هـ)	الجرجاني	n
أبو الوليد إسماعيل بن محمد بن عامر بن حبيب الحميري (المتوفى : نحو 440هـ)	أبو الوليد إسماعيل بن محمد بن عامر بن حبيب الحميري (المتوفى: نحو 440هـ)	y
أبو القاسم، محمد بن أحمد بن محمد بن عبد الله، ابن جزي الكلبي الغرناطي (المتوفى: 741هـ)	أحمد محمد عبد الله	n
أبو الحسن علي بن إبراهيم بن محمد بن عيسي بن سعد الخير الأنصاري (المتوفى: 571هـ)	ابن سعد الخير ، علي بن إبراهيم (المتوفى : 571هـ)	y
"نور الدين أبو الحسن على بن سلطان محمد القاري الهروي المعروف ""بملا على القاري"""	علي بن سلطان محمد الهروي القاري	y
السمعاني	منصور بن محمد السمعاني أبو المظفر	y
أبو الحسن تقي الدين علي بن عبد الكافي السبكي (المتوفى: 756هـ)	تقي الدين علي بن عبد الكافي السبكي (المتوفى : 756هـ)	y
أبو عبد الله محمد بن فتوح بن عبد الله الحميدي (المتوفى : 488هـ)	عبد الله بن محمد الأندلسي أبو محمد	n
أبو الحسن علي بن محمد بن محمد بن حبيب البصري البغدادي، الشهير بالماوردي (المتوفى : 450هـ)	البغدادي	n
أبو القاسم محمود بن عمرو بن أحمد، الزمخشري جار الله (المتوفى: 538 هـ)	أبو القاسم محمود بن عمرو بن أحمد، الزمخشري جار الله (المتوفى: 538هـ)	y
هبة الله بن الحسن الطبري اللالكائي	هبة الله بن الحسن بن منصور اللالكائي أبو القاسم	y
أحمد بن عمرو بن أبي عاصم الشيباني أبو بكر	عمرو بن أبي عاصم الضحاك الشيباني	y
أبو الوليد إسماعيل بن محمد بن عامر بن حبيب الحميري (المتوفى: نحو 440هـ)	الحميري	n
أبو الحارث سريج بن يونس بن إبراهيم البغدادي (المتوفى: 235هـ)	البغدادي	n
أبو القاسم تمام بن محمد بن عبد الله بن جعفر بن عبد الله بن الجنيد البجلي الرازي ثم الدمشقي (المتوفى: 414هـ)	تمام بن محمد الدمشقي	y
أبو الفرج عبد الرحمن ابن الجوزي	عبد الرحمن بن علي بن محمد بن الجوزي أبو الفرج	y
أبو الحسن ظهير الدين علي بن زيد البيهقي، الشهير بابن فندمه (المتوفى: 565هـ)	زيد بن علي	n
أبو الحسن أحمد بن عبد الله بن صالح العجلى الكوفى (المتوفى: 261هـ)	الحسن بن أحمد بن عبد الله أبو علي	n
أبو الفرج عبد الرحمن بن الجوزي الحنبلي	ابو الفرج عبد الرحمن بن علي بن الجوزي	y
أبو الحسن بن عبد الرحمن بن خلاد الرامهرمزي	أبو محمد الحسن بن عبد الرحمن بن خلاد الرامهرمزي الفارسي (المتوفى: 360هـ)	y
أبو إسماعيل عبد الله بن محمد بن علي الأنصاري الهروي (المتوفى: 481هـ)	محمد بن عبد الله الأنصاري	n
أحمد بن محمد بن علي بن حجر الهيتمي أبو العباس	ابن حجر الهيتمي	y
أبو منصور عبد الملك عبد الملك بن محمد بن إسماعيل الثعالبي	عبد الملك بن محمد بن إسماعيل أبو منصور الثعالبي (المتوفى: 429هـ)	y
أبو الفداء زين الدين أبو العدل قاسم بن قطلوبغا السودوني (نسبة إلى معتق أبيه سودون الشيخوني) الجمالي الحنفي (المتوفى: 879هـ)	زين الدين أبو العدل قاسم بن قطلوبغا السودوني (نسبة إلى معتق أبيه سودون الشيخوني) الجمالي الحنفي (المتوفى: 879هـ)	y
أبو بكر بن أبي داود، عبد الله بن سليمان بن الأشعث الأزدي السجستاني (المتوفى: 316هـ)	سليمان بن الأشعث	m
الواحدي	علي بن أحمد الواحدي أبو الحسن	y
أبو العباس الحسن بن سفيان بن عامر بن عبد العزيز بن النعمان بن عطاء الشيباني الخراساني الفسوي (المتوفى : 303هـ)	أبو العباس الحسن بن سفيان بن عامر بن عبد العزيز بن النعمان بن عطاء الشيباني الخراساني النسوي (المتوفى: 303هـ)	y
أبو منصور الثعالبي	عبد الملك بن محمد بن إسماعيل أبو منصور الثعالبي	y
الحسن بن عبد الرحمن الرامهرمزي	الرامهرمزي	y
أحمد بن علي أبو بكر الخطيب البغدادي	أحمد بن علي بن ثابت أبو بكر الخطيب البغدادي	y
أبو الفتح عثمان ابن جني	أبو الفتح عثمان ابن جني النحوي الموصلي	y
أبو منصور الثعالبي	عبد الملك بن محمد بن إسماعيل أبو منصور الثعالبي (المتوفى : 429هـ)	y
أبي الفضل جلال الدين عبد الرحمن السيوطي	جلال الدين أبي الفضل عبد الرحمن السيوطي	y
أبو القاسم هبة الله بن سلامة بن نصر بن علي البغدادي المقري (المتوفى: 410هـ)	هبة الله بن سلامة بن نصر المقري	y
أبو المعالي الجويني الملقب بإمام الحرمين (المتوفى: 478هـ)	عبد الملك الجويني	y
أبو الحسن علي بن عمر بن أحمد الدارقطني	علي بن عمر أبو الحسن الدارقطني	y
أبو بكر جعفر بن محمد بن الحسن بن المستفاض الفريابي	أبو بكر جعفر بن محمد بن الحسن بن المستفاض الفريابي (المتوفى: 301هـ)	y
محمد بن طاهر المقدسي	محمد بن طاهر بن علي المقدسي أبو الفضل	y
أبو القاسم شهاب الدين عبد الرحمن بن إسماعيل بن إبراهيم المقدسي الدمشقي المعروف بأبي شامة (المتوفى: 665هـ)	عبد الرحمن بن إسماعيل أبو شامة	y
محمد بن أحمد بن أحمد بن رشد القرطبي أبو الوليد	محمد بن أحمد بن محمد بن رشد القرطبي أبو الوليد	y
أبو القاسم خلف بن عبد الملك بن مسعود بن بشكوال الخزرجي الأنصاري الأندلسي (المتوفى: 578هـ)	خلف بن عبد الملك بن بشكوال أبو القاسم	y
أبو الفرج عبد الرحمن بن الجوزي الحنبلي	عبد الرحمن بن قدامه	n
أبو الفرج عبد الرحمن بن أبي الحسن الجوزي	أبو الفرج عبد الرحمن بن علي بن الجوزي	y
أبو الحسن علي بن عمر بن محمد ابن الحسن بن شاذان الحميري البغدادي الحربي (المتوفى : 386هـ)	البغدادي	n
أبو الفداء زين الدين قاسم بن قطلوبغا السودوني	زين الدين أبو العدل قاسم بن قطلوبغا السودوني (نسبة إلى معتق أبيه سودون الشيخوني) الجمالي الحنفي (المتوفى: 879هـ)	y
أبو الفرج عبد الرحمن بن الجوزي الحنبلي	عبد الرحمن بن أحمد بن رجب الحنبلي	n
أبو بكر أحمد بن الحسين بن علي بن موسى البيهقي	أحمد بن الحسين البيهقي	y
أحمد بن علي العسقلاني أبو الفضل	أحمد بن علي بن حجر العسقلاني أبو الفضل	y
أبو أمية محمد بن إبراهيم بن مسلم الخزاعي البغدادي ثم الطرسوسي (المتوفى: 273هـ)	محمد بن إبراهيم الطرسوسي أبو أمية	y
أبو النضر سعيد بن أبي عروبة: مهران العدوي ـ ولاء ـ البصري (المتوفى : 156هـ)	أبو النضر سعيد بن أبي عروبة: مهران العدوي ـ ولاء ـ البصري (المتوفى: 156هـ)	y
أبو المظفر مؤيد الدولة مجد الدين أسامة بن مرشد بن علي بن منقذ الكناني (المتوفى : 584هـ)	أسامة بن منقذ	m
شمس الدين أبو الخير محمد بن عبد الرحمن بن محمد السخاوي (المتوفى: 902هـ)	شمس الدين أبو الخير محمد بن عبد الرحمن بن محمد بن أبي بكر بن عثمان بن محمد السخاوي (المتوفى: 902هـ)	y
أبو البركات كمال الدين عبد الرحمن بت محمد بن عبيد الله بن أبي سعيد الأنباري	عبد الرحمن بن محمد بن عبيد الله الأنصاري، أبو البركات، كمال الدين الأنباري (المتوفى: 577هـ)	y
أبو الفرج عبد الرحمن بن علي بن محمد بن علي بن الجوزي	أبي الفرج عبد الرحمن بن الجوزي	y
أبو الحسن علي بن عمر بن أحمد بن مهدي بن مسعود بن النعمان بن دينار البغدادي الدارقطني (المتوفى: 385هـ)	علي بن عمر أبو الحسن الدارقطني البغدادي	y
أبو الفرج عبد الرحمن ابن الجوزي	جمال الدين أبو الفرج عبد الرحمن بن علي بن محمد الجوزي (المتوفى: 597هـ) (منسوب خطأ في المطبوع لابن قيم الجوزية)	y
أبو الحسن علي بن إسماعيل بن سيده المرسي [ت: 458هـ]	علي بن إسماعيل بن سيده (المتوفى: 458هـ)	y
علي بن عمر أبو الحسن الدارقطني البغدادي	علي بن عمر بن أحمد الدارقطني	y
عبد الملك بن محمد بن إسماعيل أبو منصور الثعالبي	عبد الملك بن محمد بن إسماعيل أبو منصور الثعالبي (المتوفى : 429هـ)	y
أبو القاسم محمود بن عمر الزمخشري الخوارزمي	محمود بن عمر الزمخشري	y
أبو الفضل عبد الرحيم بن الحسين العراقي	عبد الرحيم العراقي	y
أحمد بن عبد الله العمري	محمد بن أحمد بن محمد بن داود بن سلامة اليزلتيني، التونسي القاهري، المالكي، الوفائي، الشاذلي، ويعرف بابن زغدان (أبو عبد الله، أبو المواهب) (المتوفى: 882هـ)	n
أبو المظفر، منصور بن محمد بن عبد الجبار ابن أحمد المروزى السمعاني التميمي الحنفي ثم الشافعي (المتوفى: 489هـ)	منصور بن محمد السمعاني أبو المظفر	y
أبو الفرج عبد الرحمن بن علي بن الجوزي	عبد الرحمن بن علي بن الجوزي	y
علي بن سلطان محمد القاري	علي بن سلطان محمد الهروي القاري	y
أبو إبراهيم إسماعيل بن يحيى المزني	إسماعيل المزني	y
أبو بكر أحمد بن محمد بن هارون بن يزيد الخلال البغدادي الحنبلي (المتوفى : 311هـ)	البغدادي	n
أبو بكر عبد الله بن أبي الدنيا	أبو بكر عبد الله بن محمد بن عبيد البغدادي (ابن أبي الدنيا)	y
أحمد بن علي بن حجر أبو الفضل العسقلاني	أحمد بن علي بن محمد بن حجر العسقلاني	y
أبو الفضل أحمد بن علي بن محمد بن أحمد بن حجر العسقلاني (المتوفى: 852هـ)	أحمد بن علي العسقلاني أبو الفضل	y
أبو القاسم، عبد الله بن محمد بن إسحاق بن يزيد، المروزي الأصل، البغدادي، ويعرف بحامض رأسه (المتوفى: 329هـ)	البغدادي	n
أبو بكر أحمد بن موسى بن مردويه بن فورك بن موسى بن جعفر الأصبهاني (المتوفى : 410هـ)	الأصبهاني	n
أبو الفرج عبد الرحمن بن علي الجوزي	عبد الرحمن بن علي بن محمد الجوزي	y
أبو الحسن علي بن عمر بن أحمد الدارقطني	علي بن عمر الدارقطني	y
جمال الدين أبي الفرج عبد الرحمن بن الجوزي	عبد الرحمن بن علي بن محمد الجوزي	y
أبو منصور عبد الملك عبد الملك بن محمد بن إسماعيل الثعالبي	عبد الملك بن محمد بن إسماعيل أبو منصور الثعالبي (المتوفى: 429 هـ)	y
أبو أحمد حميد بن مخلد بن قتيبة بن عبد الله الخرساني المعروف بابن زنجويه (المتوفى : 251هـ)	أبو أحمد حميد بن مخلد بن قتيبة بن عبد الله الخرساني المعروف بابن زنجويه (المتوفى: 251هـ)	y
أبو الحسن نور الدين علي بن أبي بكر بن سليمان الهيثمي (المتوفى: 807هـ)	علي بن أبي بكر الهيثمي أبو الحسن	y
أحمد بن الحسين البيهقي	أحمد بن الحسين بن علي بن موسى الخسروجردي الخراساني، أبو بكر البيهقي (المتوفى : 458هـ)	y
أبو بكر جعفر بن محمد بن الحسن بن المستفاض الفريابي	جعفر بن محمد بن الحسن الفريابي	y
أحمد بن محمد بن علي بن حجر الهيتمي	الهيتمي	y
علي بن عمر الدارقطني	علي بن عمر بن أحمد الدارقطني أبو الحسن	y
أبو بكر أحمد بن إبراهيم بن إسماعيل بن العباس بن مرداس الإسماعيلي الجرجاني (المتوفى: 371هـ)	الجرجاني	n
أبو السعادات المبارك بن محمد الجزري	محمد المبارك	n
جلال الدين السيوطي	جلال الدين عبد الرحمن السيوطي	y
أبو بكر عبد الله ابن الشيخ أبي منصور محمد ابن الشيخ الكبير أبي الحسين أحمد بن محمد بن عبد الله بن النقور البغدادي، البزاز (المتوفى: 565هـ)	الشيخ عبد الحسين	n
أبو الفرج عبد الرحمن بن الجوزي الحنبلي	عبد الرحمن بن الجوزي أبو الفرج	y
أبو المظفر منصور بن محمد بن عبد الجبار السمعاني	أبو المظفر، منصور بن محمد بن عبد الجبار ابن أحمد المروزى السمعاني التميمي الحنفي ثم الشافعي (المتوفى: 489هـ)	y
ابن الأثير	ابن الأثير الجزري	y
أبو عبد الله محمد بن فتوح بن عبد الله الحميدي (المتوفى : 488هـ)	محمد بن عبد الله بن محمد اللواتي أبو عبد الله	n
أبو بكر عبد الله بن محمد بن عبيد البغدادي (ابن أبي الدنيا)	أبو بكر عبد الله بن محمد بن عبيد بن سفيان بن قيس البغدادي الأموي القرشي المعروف بابن أبي الدنيا (المتوفى: 281هـ)	y
أبو الفرج عبد الرحمن بن علي بن محمد بن علي بن عبيد الله بن عبد الله بن هادي بن أحمد بن محمد بن جعفر الجوزي	ابو الفرج عبد الرحمن بن علي بن الجوزي	y
أبو الفرج عبد الرحمن بن علي الجوزي	أبو الفرج عبد الرحمن بن علي بن محمد القرشي	y
أبو الحسن علي بن محمد الماوردي	أبو الحسن علي بن محمد بن حبيب الماوردي البصري	y
أبو الحسين محمد بن أحمد بن عبد الرحمن بن يحيى بن جميع الغساني الصيداوي (المتوفى: 402هـ)	محمد بن أحمد بن الحسين	n
أحمد بن علي بن ثابت البغدادي أبو بكر	أحمد بن علي بن ثابت الخطيب البغدادي أبو بكر	y
أبو الفرج عبد الرحمن بن أحمد بن رجب الحنبلي (المتوفى: 795هـ)	أبو الفرج عبد الرحمن بن الجوزي الحنبلي	n
أبو الحسين عبد الباقي بن قانع بن مرزوق بن واثق الأموي بالولاء البغدادي (المتوفى: 351هـ)	البغدادي	n
أحمد بن عمرو بن أبي عاصم الضحاك أبو بكر	عمرو بن أبي عاصم	y
أبو بكر أحمد بن علي بن ثابت الخطيب	أحمد بن علي بن ثابت البغدادي	y
عبد الملك بن محمد بن إسماعيل أبو منصور الثعالبي	عبد الملك بن محمد بن إسماعيل أبو منصور الثعالبي (المتوفى: 429هـ)	y
جار الله الزمخشري	محمود بن عمر الزمخشري	y
أبو الحسن علي بن أبي الكرم محمد بن محمد بن عبد الكريم بن عبد الواحد الشيباني الجزري، عز الدين ابن الأثير (المتوفى: 630هـ)	الشيباني	n
أبو الفرج عبد الرحمن بن أبي الحسن الجوزي	أبي الفرج عبد الرحمن بن الجوزي	y
أبو الفداء إسماعيل بن عمر بن كثير القرشي الدمشقي (المتوفى : 774هـ)	أبو الفداء إسماعيل بن عمر بن كثير القرشي الدمشقي (المتوفى: 774هـ)	y